รรNรNยดรNยดรฒรNยดรฒ*รNยดรฒ*ยรNยดรฒ*ยยรNยดรฒ*ยย}รNยดรฒ*ยย}ยตรNยดรฒ*ยย}ยต9รNยดรฒ*ยย}ยต9ยณรNยดรฒ*ยย}ยต9ยณยรNยดรฒ*ยย}ยต9ยณยรNยดรฒ*ยย}ยต9ยณยรNยดรฒ*ยย}ยต9ยณยAรNยดรฒ*ยย}ยต9ยณยAรฌรNยดรฒ*ยย}ยต9ยณยAรฌรรNยดรฒ*ยย}ยต9ยณยAรฌรรรNยดรฒ*ยย}ยต9ยณยAรฌรรUรNยดรฒ*ยย}ยต9ยณยAรฌรรUยรNยดรฒ*ยย}ยต9ยณยAรฌรรUยTรNยดรฒ*ยย}ยต9ยณยAรฌรรUยTaรNยดรฒ*ยย}ยต9ยณยAรฌรรUยTaรฑรNยดรฒ*ยย}ยต9ยณยAรฌรรUยTaรฑยรNยดรฒ*ยย}ยต9ยณยAรฌรรUยTaรฑยรดรNยดรฒ*ยย}ยต9ยณยAรฌรรUยTaรฑยรดยชรNยดรฒ*ยย}ยต9ยณยAรฌรรUยTaรฑยรดยช'รNยดรฒ*ยย}ยต9ยณยAรฌรรUยTaรฑยรดยช'ยรNยดรฒ*ยย}ยต9ยณยAรฌรรUยTaรฑยรดยช'ย5รNยดรฒ*ยย}ยต9ยณยAรฌรรUยTaรฑยรดยช'ย5jรNยดรฒ*ยย}ยต9ยณยAรฌรรUยTaรฑยรดยช'ย5jรถรNยดรฒ*ยย}ยต9ยณยAรฌรรUยTaรฑยรดยช'ย5jรถรครNยดรฒ*ยย}ยต9ยณยAรฌรรUยTaรฑยรดยช'ย5jรถรครดรNยดรฒ*ยย}ยต9ยณยAรฌรรUยTaรฑยรดยช'ย5jรถรครด>รNยดรฒ*ยย}ยต9ยณยAรฌรรUยTaรฑยรดยช'ย5jรถรครด>รรNยดรฒ*ยย}ยต9ยณยAรฌรรUยTaรฑยรดยช'ย5jรถรครด>รรNยดรฒ*ยย}ยต9ยณยAรฌรรUยTaรฑยรดยช'ย5jรถรครด>รรรNยดรฒ*ยย}ยต9ยณยAรฌรรUยTaรฑยรดยช'ย5jรถรครด>รรIรNยดรฒ*ยย}ยต9ยณยAรฌรรUยTaรฑยรดยช'ย5jรถรครด>รรIdรNยดรฒ*ยย}ยต9ยณยAรฌรรUยTaรฑยรดยช'ย5jรถรครด>รรId0รNยดรฒ*ยย}ยต9ยณยAรฌรรUยTaรฑยรดยช'ย5jรถรครด>รรId01รNยดรฒ*ยย}ยต9ยณยAรฌรรUยTaรฑยรดยช'ย5jรถรครด>รรId01	รNยดรฒ*ยย}ยต9ยณยAรฌรรUยTaรฑยรดยช'ย5jรถรครด>รรId01	:รNยดรฒ*ยย}ยต9ยณยAรฌรรUยTaรฑยรดยช'ย5jรถรครด>รรId01	:รรNยดรฒ*ยย}ยต9ยณยAรฌรรUยTaรฑยรดยช'ย5jรถรครด>รรId01	:รยรNยดรฒ*ยย}ยต9ยณยAรฌรรUยTaรฑยรดยช'ย5jรถรครด>รรId01	:รยรฒรNยดรฒ*ยย}ยต9ยณยAรฌรรUยTaรฑยรดยช'ย5jรถรครด>รรId01	:รยรฒยงรNยดรฒ*ยย}ยต9ยณยAรฌรรUยTaรฑยรดยช'ย5jรถรครด>รรId01	:รยรฒยงjรNยดรฒ*ยย}ยต9ยณยAรฌรรUยTaรฑยรดยช'ย5jรถรครด>รรId01	:รยรฒยงjยรNยดรฒ*ยย}ยต9ยณยAรฌรรUยTaรฑยรดยช'ย5jรถรครด>รรId01	:รยรฒยงjยยบรNยดรฒ*ยย}ยต9ยณยAรฌรรUยTaรฑยรดยช'ย5jรถรครด>รรId01	:รยรฒยงjยยบeรNยดรฒ*ยย}ยต9ยณยAรฌรรUยTaรฑยรดยช'ย5jรถรครด>รรId01	:รยรฒยงjยยบeoรNยดรฒ*ยย}ยต9ยณยAรฌรรUยTaรฑยรดยช'ย5jรถรครด>รรId01	:รยรฒยงjยยบeo?รNยดรฒ*ยย}ยต9ยณยAรฌรรUยTaรฑยรดยช'ย5jรถรครด>รรId01	:รยรฒยงjยยบeo?QรNยดรฒ*ยย}ยต9ยณยAรฌรรUยTaรฑยรดยช'ย5jรถรครด>รรId01	:รยรฒยงjยยบeo?QยรNยดรฒ*ยย}ยต9ยณยAรฌรรUยTaรฑยรดยช'ย5jรถรครด>รรId01	:รยรฒยงjยยบeo?QยHรNยดรฒ*ยย}ยต9ยณยAรฌรรUยTaรฑยรดยช'ย5jรถรครด>รรId01	:รยรฒยงjยยบeo?QยHรรNยดรฒ*ยย}ยต9ยณยAรฌรรUยTaรฑยรดยช'ย5jรถรครด>รรId01	:รยรฒยงjยยบeo?QยHรรจรNยดรฒ*ยย}ยต9ยณยAรฌรรUยTaรฑยรดยช'ย5jรถรครด>รรId01	:รยรฒยงjยยบeo?QยHรรจ0รNยดรฒ*ยย}ยต9ยณยAรฌรรUยTaรฑยรดยช'ย5jรถรครด>รรId01	:รยรฒยงjยยบeo?QยHรรจ0MรNยดรฒ*ยย}ยต9ยณยAรฌรรUยTaรฑยรดยช'ย5jรถรครด>รรId01	:รยรฒยงjยยบeo?QยHรรจ0MรNยดรฒ*ยย}ยต9ยณยAรฌรรUยTaรฑยรดยช'ย5jรถรครด>รรId01	:รยรฒยงjยยบeo?QยHรรจ0MรขรNยดรฒ*ยย}ยต9ยณยAรฌรรUยTaรฑยรดยช'ย5jรถรครด>รรId01	:รยรฒยงjยยบeo?QยHรรจ0MรขรปรNยดรฒ*ยย}ยต9ยณยAรฌรรUยTaรฑยรดยช'ย5jรถรครด>รรId01	:รยรฒยงjยยบeo?QยHรรจ0MรขรปrรNยดรฒ*ยย}ยต9ยณยAรฌรรUยTaรฑยรดยช'ย5jรถรครด>รรId01	:รยรฒยงjยยบeo?QยHรรจ0Mรขรปr$รNยดรฒ*ยย}ยต9ยณยAรฌรรUยTaรฑยรดยช'ย5jรถรครด>รรId01	:รยรฒยงjยยบeo?QยHรรจ0Mรขรปr$รรNยดรฒ*ยย}ยต9ยณยAรฌรรUยTaรฑยรดยช'ย5jรถรครด>รรId01	:รยรฒยงjยยบeo?QยHรรจ0Mรขรปr$รยรNยดรฒ*ยย}ยต9ยณยAรฌรรUยTaรฑยรดยช'ย5jรถรครด>รรId01	:รยรฒยงjยยบeo?QยHรรจ0Mรขรปr$รยรNยดรฒ*ยย}ยต9ยณยAรฌรรUยTaรฑยรดยช'ย5jรถรครด>รรId01	:รยรฒยงjยยบeo?QยHรรจ0Mรขรปr$รยHรNยดรฒ*ยย}ยต9ยณยAรฌรรUยTaรฑยรดยช'ย5jรถรครด>รรId01	:รยรฒยงjยยบeo?QยHรรจ0Mรขรปr$รยH]รNยดรฒ*ยย}ยต9ยณยAรฌรรUยTaรฑยรดยช'ย5jรถรครด>รรId01	:รยรฒยงjยยบeo?QยHรรจ0Mรขรปr$รยH]รNยดรฒ*ยย}ยต9ยณยAรฌรรUยTaรฑยรดยช'ย5jรถรครด>รรId01	:รยรฒยงjยยบeo?QยHรรจ0Mรขรปr$รยH]รฟรNยดรฒ*ยย}ยต9ยณยAรฌรรUยTaรฑยรดยช'ย5jรถรครด>รรId01	:รยรฒยงjยยบeo?QยHรรจ0Mรขรปr$รยH]รฟยถรNยดรฒ*ยย}ยต9ยณยAรฌรรUยTaรฑยรดยช'ย5jรถรครด>รรId01	:รยรฒยงjยยบeo?QยHรรจ0Mรขรปr$รยH]รฟยถยปรNยดรฒ*ยย}ยต9ยณยAรฌรรUยTaรฑยรดยช'ย5jรถรครด>รรId01	:รยรฒยงjยยบeo?QยHรรจ0Mรขรปr$รยH]รฟยถยป=รNยดรฒ*ยย}ยต9ยณยAรฌรรUยTaรฑยรดยช'ย5jรถรครด>รรId01	:รยรฒยงjยยบeo?QยHรรจ0Mรขรปr$รยH]รฟยถยป=รรNยดรฒ*ยย}ยต9ยณยAรฌรรUยTaรฑยรดยช'ย5jรถรครด>รรId01	:รยรฒยงjยยบeo?QยHรรจ0Mรขรปr$รยH]รฟยถยป=รรทรNยดรฒ*ยย}ยต9ยณยAรฌรรUยTaรฑยรดยช'ย5jรถรครด>รรId01	:รยรฒยงjยยบeo?QยHรรจ0Mรขรปr$รยH]รฟยถยป=รรท[รNยดรฒ*ยย}ยต9ยณยAรฌรรUยTaรฑยรดยช'ย5jรถรครด>รรId01	:รยรฒยงjยยบeo?QยHรรจ0Mรขรปr$รยH]รฟยถยป=รรท[[รNยดรฒ*ยย}ยต9ยณยAรฌรรUยTaรฑยรดยช'ย5jรถรครด>รรId01	:รยรฒยงjยยบeo?QยHรรจ0Mรขรปr$รยH]รฟยถยป=รรท[[ยรNยดรฒ*ยย}ยต9ยณยAรฌรรUยTaรฑยรดยช'ย5jรถรครด>รรId01	:รยรฒยงjยยบeo?QยHรรจ0Mรขรปr$รยH]รฟยถยป=รรท[[ย(รNยดรฒ*ยย}ยต9ยณยAรฌรรUยTaรฑยรดยช'ย5jรถรครด>รรId01	:รยรฒยงjยยบeo?QยHรรจ0Mรขรปr$รยH]รฟยถยป=รรท[[ย(	รNยดรฒ*ยย}ยต9ยณยAรฌรรUยTaรฑยรดยช'ย5jรถรครด>รรId01	:รยรฒยงjยยบeo?QยHรรจ0Mรขรปr$รยH]รฟยถยป=รรท[[ย(	xรNยดรฒ*ยย}ยต9ยณยAรฌรรUยTaรฑยรดยช'ย5jรถรครด>รรId01	:รยรฒยงjยยบeo?QยHรรจ0Mรขรปr$รยH]รฟยถยป=รรท[[ย(	xยฌรNยดรฒ*ยย}ยต9ยณยAรฌรรUยTaรฑยรดยช'ย5jรถรครด>รรId01	:รยรฒยงjยยบeo?QยHรรจ0Mรขรปr$รยH]รฟยถยป=รรท[[ย(	xยฌfรNยดรฒ*ยย}ยต9ยณยAรฌรรUยTaรฑยรดยช'ย5jรถรครด>รรId01	:รยรฒยงjยยบeo?QยHรรจ0Mรขรปr$รยH]รฟยถยป=รรท[[ย(	xยฌfยรNยดรฒ*ยย}ยต9ยณยAรฌรรUยTaรฑยรดยช'ย5jรถรครด>รรId01	:รยรฒยงjยยบeo?QยHรรจ0Mรขรปr$รยH]รฟยถยป=รรท[[ย(	xยฌfยรNยดรฒ*ยย}ยต9ยณยAรฌรรUยTaรฑยรดยช'ย5jรถรครด>รรId01	:รยรฒยงjยยบeo?QยHรรจ0Mรขรปr$รยH]รฟยถยป=รรท[[ย(	xยฌfยรNยดรฒ*ยย}ยต9ยณยAรฌรรUยTaรฑยรดยช'ย5jรถรครด>รรId01	:รยรฒยงjยยบeo?QยHรรจ0Mรขรปr$รยH]รฟยถยป=รรท[[ย(	xยฌfยรรNยดรฒ*ยย}ยต9ยณยAรฌรรUยTaรฑยรดยช'ย5jรถรครด>รรId01	:รยรฒยงjยยบeo?QยHรรจ0Mรขรปr$รยH]รฟยถยป=รรท[[ย(	xยฌfยรรรNยดรฒ*ยย}ยต9ยณยAรฌรรUยTaรฑยรดยช'ย5jรถรครด>รรId01	:รยรฒยงjยยบeo?QยHรรจ0Mรขรปr$รยH]รฟยถยป=รรท[[ย(	xยฌfยรรยรNยดรฒ*ยย}ยต9ยณยAรฌรรUยTaรฑยรดยช'ย5jรถรครด>รรId01	:รยรฒยงjยยบeo?QยHรรจ0Mรขรปr$รยH]รฟยถยป=รรท[[ย(	xยฌfยรรยยชรNยดรฒ*ยย}ยต9ยณยAรฌรรUยTaรฑยรดยช'ย5jรถรครด>รรId01	:รยรฒยงjยยบeo?QยHรรจ0Mรขรปr$รยH]รฟยถยป=รรท[[ย(	xยฌfยรรยยชlรNยดรฒ*ยย}ยต9ยณยAรฌรรUยTaรฑยรดยช'ย5jรถรครด>รรId01	:รยรฒยงjยยบeo?QยHรรจ0Mรขรปr$รยH]รฟยถยป=รรท[[ย(	xยฌfยรรยยชlรรNยดรฒ*ยย}ยต9ยณยAรฌรรUยTaรฑยรดยช'ย5jรถรครด>รรId01	:รยรฒยงjยยบeo?QยHรรจ0Mรขรปr$รยH]รฟยถยป=รรท[[ย(	xยฌfยรรยยชlร<รNยดรฒ*ยย}ยต9ยณยAรฌรรUยTaรฑยรดยช'ย5jรถรครด>รรId01	:รยรฒยงjยยบeo?QยHรรจ0Mรขรปr$รยH]รฟยถยป=รรท[[ย(	xยฌfยรรยยชlร<รรNยดรฒ*ยย}ยต9ยณยAรฌรรUยTaรฑยรดยช'ย5jรถรครด>รรId01	:รยรฒยงjยยบeo?QยHรรจ0Mรขรปr$รยH]รฟยถยป=รรท[[ย(	xยฌfยรรยยชlร<ร)รNยดรฒ*ยย}ยต9ยณยAรฌรรUยTaรฑยรดยช'ย5jรถรครด>รรId01	:รยรฒยงjยยบeo?QยHรรจ0Mรขรปr$รยH]รฟยถยป=รรท[[ย(	xยฌfยรรยยชlร<ร)MรNยดรฒ*ยย}ยต9ยณยAรฌรรUยTaรฑยรดยช'ย5jรถรครด>รรId01	:รยรฒยงjยยบeo?QยHรรจ0Mรขรปr$รยH]รฟยถยป=รรท[[ย(	xยฌfยรรยยชlร<ร)MรงรNยดรฒ*ยย}ยต9ยณยAรฌรรUยTaรฑยรดยช'ย5jรถรครด>รรId01	:รยรฒยงjยยบeo?QยHรรจ0Mรขรปr$รยH]รฟยถยป=รรท[[ย(	xยฌfยรรยยชlร<ร)MรงรNยดรฒ*ยย}ยต9ยณยAรฌรรUยTaรฑยรดยช'ย5jรถรครด>รรId01	:รยรฒยงjยยบeo?QยHรรจ0Mรขรปr$รยH]รฟยถยป=รรท[[ย(	xยฌfยรรยยชlร<ร)MรงรNยดรฒ*ยย}ยต9ยณยAรฌรรUยTaรฑยรดยช'ย5jรถรครด>รรId01	:รยรฒยงjยยบeo?QยHรรจ0Mรขรปr$รยH]รฟยถยป=รรท[[ย(	xยฌfยรรยยชlร<ร)MรงOรNยดรฒ*ยย}ยต9ยณยAรฌรรUยTaรฑยรดยช'ย5jรถรครด>รรId01	:รยรฒยงjยยบeo?QยHรรจ0Mรขรปr$รยH]รฟยถยป=รรท[[ย(	xยฌfยรรยยชlร<ร)MรงOยฅรNยดรฒ*ยย}ยต9ยณยAรฌรรUยTaรฑยรดยช'ย5jรถรครด>รรId01	:รยรฒยงjยยบeo?QยHรรจ0Mรขรปr$รยH]รฟยถยป=รรท[[ย(	xยฌfยรรยยชlร<ร)MรงOยฅรรNยดรฒ*ยย}ยต9ยณยAรฌรรUยTaรฑยรดยช'ย5jรถรครด>รรId01	:รยรฒยงjยยบeo?QยHรรจ0Mรขรปr$รยH]รฟยถยป=รรท[[ย(	xยฌfยรรยยชlร<ร)MรงOยฅรรขรNยดรฒ*ยย}ยต9ยณยAรฌรรUยTaรฑยรดยช'ย5jรถรครด>รรId01	:รยรฒยงjยยบeo?QยHรรจ0Mรขรปr$รยH]รฟยถยป=รรท[[ย(	xยฌfยรรยยชlร<ร)MรงOยฅรรขรNยดรฒ*ยย}ยต9ยณยAรฌรรUยTaรฑยรดยช'ย5jรถรครด>รรId01	:รยรฒยงjยยบeo?QยHรรจ0Mรขรปr$รยH]รฟยถยป=รรท[[ย(	xยฌfยรรยยชlร<ร)MรงOยฅรรขnรNยดรฒ*ยย}ยต9ยณยAรฌรรUยTaรฑยรดยช'ย5jรถรครด>รรId01	:รยรฒยงjยยบeo?QยHรรจ0Mรขรปr$รยH]รฟยถยป=รรท[[ย(	xยฌfยรรยยชlร<ร)MรงOยฅรรขnยรNยดรฒ*ยย}ยต9ยณยAรฌรรUยTaรฑยรดยช'ย5jรถรครด>รรId01	:รยรฒยงjยยบeo?QยHรรจ0Mรขรปr$รยH]รฟยถยป=รรท[[ย(	xยฌfยรรยยชlร<ร)MรงOยฅรรขnยรNยดรฒ*ยย}ยต9ยณยAรฌรรUยTaรฑยรดยช'ย5jรถรครด>รรId01	:รยรฒยงjยยบeo?QยHรรจ0Mรขรปr$รยH]รฟยถยป=รรท[[ย(	xยฌfยรรยยชlร<ร)MรงOยฅรรขnยSรNยดรฒ*ยย}ยต9ยณยAรฌรรUยTaรฑยรดยช'ย5jรถรครด>รรId01	:รยรฒยงjยยบeo?QยHรรจ0Mรขรปr$รยH]รฟยถยป=รรท[[ย(	xยฌfยรรยยชlร<ร)MรงOยฅรรขnยSยกรNยดรฒ*ยย}ยต9ยณยAรฌรรUยTaรฑยรดยช'ย5jรถรครด>รรId01	:รยรฒยงjยยบeo?QยHรรจ0Mรขรปr$รยH]รฟยถยป=รรท[[ย(	xยฌfยรรยยชlร<ร)MรงOยฅรรขnยSยกiรNยดรฒ*ยย}ยต9ยณยAรฌรรUยTaรฑยรดยช'ย5jรถรครด>รรId01	:รยรฒยงjยยบeo?QยHรรจ0Mรขรปr$รยH]รฟยถยป=รรท[[ย(	xยฌfยรรยยชlร<ร)MรงOยฅรรขnยSยกiรรNยดรฒ*ยย}ยต9ยณยAรฌรรUยTaรฑยรดยช'ย5jรถรครด>รรId01	:รยรฒยงjยยบeo?QยHรรจ0Mรขรปr$รยH]รฟยถยป=รรท[[ย(	xยฌfยรรยยชlร<ร)MรงOยฅรรขnยSยกiรยรNยดรฒ*ยย}ยต9ยณยAรฌรรUยTaรฑยรดยช'ย5jรถรครด>รรId01	:รยรฒยงjยยบeo?QยHรรจ0Mรขรปr$รยH]รฟยถยป=รรท[[ย(	xยฌfยรรยยชlร<ร)MรงOยฅรรขnยSยกiรยยพรNยดรฒ*ยย}ยต9ยณยAรฌรรUยTaรฑยรดยช'ย5jรถรครด>รรId01	:รยรฒยงjยยบeo?QยHรรจ0Mรขรปr$รยH]รฟยถยป=รรท[[ย(	xยฌfยรรยยชlร<ร)MรงOยฅรรขnยSยกiรยยพ!รNยดรฒ*ยย}ยต9ยณยAรฌรรUยTaรฑยรดยช'ย5jรถรครด>รรId01	:รยรฒยงjยยบeo?QยHรรจ0Mรขรปr$รยH]รฟยถยป=รรท[[ย(	xยฌfยรรยยชlร<ร)MรงOยฅรรขnยSยกiรยยพ!
รNยดรฒ*ยย}ยต9ยณยAรฌรรUยTaรฑยรดยช'ย5jรถรครด>รรId01	:รยรฒยงjยยบeo?QยHรรจ0Mรขรปr$รยH]รฟยถยป=รรท[[ย(	xยฌfยรรยยชlร<ร)MรงOยฅรรขnยSยกiรยยพ!
รชรNยดรฒ*ยย}ยต9ยณยAรฌรรUยTaรฑยรดยช'ย5jรถรครด>รรId01	:รยรฒยงjยยบeo?QยHรรจ0Mรขรปr$รยH]รฟยถยป=รรท[[ย(	xยฌfยรรยยชlร<ร)MรงOยฅรรขnยSยกiรยยพ!
รชรรNยดรฒ*ยย}ยต9ยณยAรฌรรUยTaรฑยรดยช'ย5jรถรครด>รรId01	:รยรฒยงjยยบeo?QยHรรจ0Mรขรปr$รยH]รฟยถยป=รรท[[ย(	xยฌfยรรยยชlร<ร)MรงOยฅรรขnยSยกiรยยพ!
รชร#รNยดรฒ*ยย}ยต9ยณยAรฌรรUยTaรฑยรดยช'ย5jรถรครด>รรId01	:รยรฒยงjยยบeo?QยHรรจ0Mรขรปr$รยH]รฟยถยป=รรท[[ย(	xยฌfยรรยยชlร<ร)MรงOยฅรรขnยSยกiรยยพ!
รชร#ZรNยดรฒ*ยย}ยต9ยณยAรฌรรUยTaรฑยรดยช'ย5jรถรครด>รรId01	:รยรฒยงjยยบeo?QยHรรจ0Mรขรปr$รยH]รฟยถยป=รรท[[ย(	xยฌfยรรยยชlร<ร)MรงOยฅรรขnยSยกiรยยพ!
รชร#ZรNยดรฒ*ยย}ยต9ยณยAรฌรรUยTaรฑยรดยช'ย5jรถรครด>รรId01	:รยรฒยงjยยบeo?QยHรรจ0Mรขรปr$รยH]รฟยถยป=รรท[[ย(	xยฌfยรรยยชlร<ร)MรงOยฅรรขnยSยกiรยยพ!
รชร#ZยธรNยดรฒ*ยย}ยต9ยณยAรฌรรUยTaรฑยรดยช'ย5jรถรครด>รรId01	:รยรฒยงjยยบeo?QยHรรจ0Mรขรปr$รยH]รฟยถยป=รรท[[ย(	xยฌfยรรยยชlร<ร)MรงOยฅรรขnยSยกiรยยพ!
รชร#ZยธยกรNยดรฒ*ยย}ยต9ยณยAรฌรรUยTaรฑยรดยช'ย5jรถรครด>รรId01	:รยรฒยงjยยบeo?QยHรรจ0Mรขรปr$รยH]รฟยถยป=รรท[[ย(	xยฌfยรรยยชlร<ร)MรงOยฅรรขnยSยกiรยยพ!
รชร#ZยธยกรครNยดรฒ*ยย}ยต9ยณยAรฌรรUยTaรฑยรดยช'ย5jรถรครด>รรId01	:รยรฒยงjยยบeo?QยHรรจ0Mรขรปr$รยH]รฟยถยป=รรท[[ย(	xยฌfยรรยยชlร<ร)MรงOยฅรรขnยSยกiรยยพ!
รชร#Zยธยกรค รNยดรฒ*ยย}ยต9ยณยAรฌรรUยTaรฑยรดยช'ย5jรถรครด>รรId01	:รยรฒยงjยยบeo?QยHรรจ0Mรขรปr$รยH]รฟยถยป=รรท[[ย(	xยฌfยรรยยชlร<ร)MรงOยฅรรขnยSยกiรยยพ!
รชร#Zยธยกรค ยรNยดรฒ*ยย}ยต9ยณยAรฌรรUยTaรฑยรดยช'ย5jรถรครด>รรId01	:รยรฒยงjยยบeo?QยHรรจ0Mรขรปr$รยH]รฟยถยป=รรท[[ย(	xยฌfยรรยยชlร<ร)MรงOยฅรรขnยSยกiรยยพ!
รชร#Zยธยกรค ยoรNยดรฒ*ยย}ยต9ยณยAรฌรรUยTaรฑยรดยช'ย5jรถรครด>รรId01	:รยรฒยงjยยบeo?QยHรรจ0Mรขรปr$รยH]รฟยถยป=รรท[[ย(	xยฌfยรรยยชlร<ร)MรงOยฅรรขnยSยกiรยยพ!
รชร#Zยธยกรค ยoรNยดรฒ*ยย}ยต9ยณยAรฌรรUยTaรฑยรดยช'ย5jรถรครด>รรId01	:รยรฒยงjยยบeo?QยHรรจ0Mรขรปr$รยH]รฟยถยป=รรท[[ย(	xยฌfยรรยยชlร<ร)MรงOยฅรรขnยSยกiรยยพ!
รชร#Zยธยกรค ยoยญรNยดรฒ*ยย}ยต9ยณยAรฌรรUยTaรฑยรดยช'ย5jรถรครด>รรId01	:รยรฒยงjยยบeo?QยHรรจ0Mรขรปr$รยH]รฟยถยป=รรท[[ย(	xยฌfยรรยยชlร<ร)MรงOยฅรรขnยSยกiรยยพ!
รชร#Zยธยกรค ยoยญ\รNยดรฒ*ยย}ยต9ยณยAรฌรรUยTaรฑยรดยช'ย5jรถรครด>รรId01	:รยรฒยงjยยบeo?QยHรรจ0Mรขรปr$รยH]รฟยถยป=รรท[[ย(	xยฌfยรรยยชlร<ร)MรงOยฅรรขnยSยกiรยยพ!
รชร#Zยธยกรค ยoยญ\รญรNยดรฒ*ยย}ยต9ยณยAรฌรรUยTaรฑยรดยช'ย5jรถรครด>รรId01	:รยรฒยงjยยบeo?QยHรรจ0Mรขรปr$รยH]รฟยถยป=รรท[[ย(	xยฌfยรรยยชlร<ร)MรงOยฅรรขnยSยกiรยยพ!
รชร#Zยธยกรค ยoยญ\รญsรNยดรฒ*ยย}ยต9ยณยAรฌรรUยTaรฑยรดยช'ย5jรถรครด>รรId01	:รยรฒยงjยยบeo?QยHรรจ0Mรขรปr$รยH]รฟยถยป=รรท[[ย(	xยฌfยรรยยชlร<ร)MรงOยฅรรขnยSยกiรยยพ!
รชร#Zยธยกรค ยoยญ\รญsรกรNยดรฒ*ยย}ยต9ยณยAรฌรรUยTaรฑยรดยช'ย5jรถรครด>รรId01	:รยรฒยงjยยบeo?QยHรรจ0Mรขรปr$รยH]รฟยถยป=รรท[[ย(	xยฌfยรรยยชlร<ร)MรงOยฅรรขnยSยกiรยยพ!
รชร#Zยธยกรค ยoยญ\รญsรกรNยดรฒ*ยย}ยต9ยณยAรฌรรUยTaรฑยรดยช'ย5jรถรครด>รรId01	:รยรฒยงjยยบeo?QยHรรจ0Mรขรปr$รยH]รฟยถยป=รรท[[ย(	xยฌfยรรยยชlร<ร)MรงOยฅรรขnยSยกiรยยพ!
รชร#Zยธยกรค ยoยญ\รญsรกeรNยดรฒ*ยย}ยต9ยณยAรฌรรUยTaรฑยรดยช'ย5jรถรครด>รรId01	:รยรฒยงjยยบeo?QยHรรจ0Mรขรปr$รยH]รฟยถยป=รรท[[ย(	xยฌfยรรยยชlร<ร)MรงOยฅรรขnยSยกiรยยพ!
รชร#Zยธยกรค ยoยญ\รญsรกefรNยดรฒ*ยย}ยต9ยณยAรฌรรUยTaรฑยรดยช'ย5jรถรครด>รรId01	:รยรฒยงjยยบeo?QยHรรจ0Mรขรปr$รยH]รฟยถยป=รรท[[ย(	xยฌfยรรยยชlร<ร)MรงOยฅรรขnยSยกiรยยพ!
รชร#Zยธยกรค ยoยญ\รญsรกefรNยดรฒ*ยย}ยต9ยณยAรฌรรUยTaรฑยรดยช'ย5jรถรครด>รรId01	:รยรฒยงjยยบeo?QยHรรจ0Mรขรปr$รยH]รฟยถยป=รรท[[ย(	xยฌfยรรยยชlร<ร)MรงOยฅรรขnยSยกiรยยพ!
รชร#Zยธยกรค ยoยญ\รญsรกef รNยดรฒ*ยย}ยต9ยณยAรฌรรUยTaรฑยรดยช'ย5jรถรครด>รรId01	:รยรฒยงjยยบeo?QยHรรจ0Mรขรปr$รยH]รฟยถยป=รรท[[ย(	xยฌfยรรยยชlร<ร)MรงOยฅรรขnยSยกiรยยพ!
รชร#Zยธยกรค ยoยญ\รญsรกef `รNยดรฒ*ยย}ยต9ยณยAรฌรรUยTaรฑยรดยช'ย5jรถรครด>รรId01	:รยรฒยงjยยบeo?QยHรรจ0Mรขรปr$รยH]รฟยถยป=รรท[[ย(	xยฌfยรรยยชlร<ร)MรงOยฅรรขnยSยกiรยยพ!
รชร#Zยธยกรค ยoยญ\รญsรกef `hรNยดรฒ*ยย}ยต9ยณยAรฌรรUยTaรฑยรดยช'ย5jรถรครด>รรId01	:รยรฒยงjยยบeo?QยHรรจ0Mรขรปr$รยH]รฟยถยป=รรท[[ย(	xยฌfยรรยยชlร<ร)MรงOยฅรรขnยSยกiรยยพ!
รชร#Zยธยกรค ยoยญ\รญsรกef `hรNยดรฒ*ยย}ยต9ยณยAรฌรรUยTaรฑยรดยช'ย5jรถรครด>รรId01	:รยรฒยงjยยบeo?QยHรรจ0Mรขรปr$รยH]รฟยถยป=รรท[[ย(	xยฌfยรรยยชlร<ร)MรงOยฅรรขnยSยกiรยยพ!
รชร#Zยธยกรค ยoยญ\รญsรกef `hรNยดรฒ*ยย}ยต9ยณยAรฌรรUยTaรฑยรดยช'ย5jรถรครด>รรId01	:รยรฒยงjยยบeo?QยHรรจ0Mรขรปr$รยH]รฟยถยป=รรท[[ย(	xยฌfยรรยยชlร<ร)MรงOยฅรรขnยSยกiรยยพ!
รชร#Zยธยกรค ยoยญ\รญsรกef `hoรNยดรฒ*ยย}ยต9ยณยAรฌรรUยTaรฑยรดยช'ย5jรถรครด>รรId01	:รยรฒยงjยยบeo?QยHรรจ0Mรขรปr$รยH]รฟยถยป=รรท[[ย(	xยฌfยรรยยชlร<ร)MรงOยฅรรขnยSยกiรยยพ!
รชร#Zยธยกรค ยoยญ\รญsรกef `hoNรNยดรฒ*ยย}ยต9ยณยAรฌรรUยTaรฑยรดยช'ย5jรถรครด>รรId01	:รยรฒยงjยยบeo?QยHรรจ0Mรขรปr$รยH]รฟยถยป=รรท[[ย(	xยฌfยรรยยชlร<ร)MรงOยฅรรขnยSยกiรยยพ!
รชร#Zยธยกรค ยoยญ\รญsรกef `hoNรNยดรฒ*ยย}ยต9ยณยAรฌรรUยTaรฑยรดยช'ย5jรถรครด>รรId01	:รยรฒยงjยยบeo?QยHรรจ0Mรขรปr$รยH]รฟยถยป=รรท[[ย(	xยฌfยรรยยชlร<ร)MรงOยฅรรขnยSยกiรยยพ!
รชร#Zยธยกรค ยoยญ\รญsรกef `hoNรNยดรฒ*ยย}ยต9ยณยAรฌรรUยTaรฑยรดยช'ย5jรถรครด>รรId01	:รยรฒยงjยยบeo?QยHรรจ0Mรขรปr$รยH]รฟยถยป=รรท[[ย(	xยฌfยรรยยชlร<ร)MรงOยฅรรขnยSยกiรยยพ!
รชร#Zยธยกรค ยoยญ\รญsรกef `hoNรรNยดรฒ*ยย}ยต9ยณยAรฌรรUยTaรฑยรดยช'ย5jรถรครด>รรId01	:รยรฒยงjยยบeo?QยHรรจ0Mรขรปr$รยH]รฟยถยป=รรท[[ย(	xยฌfยรรยยชlร<ร)MรงOยฅรรขnยSยกiรยยพ!
รชร#Zยธยกรค ยoยญ\รญsรกef `hoNรยฎรNยดรฒ*ยย}ยต9ยณยAรฌรรUยTaรฑยรดยช'ย5jรถรครด>รรId01	:รยรฒยงjยยบeo?QยHรรจ0Mรขรปr$รยH]รฟยถยป=รรท[[ย(	xยฌfยรรยยชlร<ร)MรงOยฅรรขnยSยกiรยยพ!
รชร#Zยธยกรค ยoยญ\รญsรกef `hoNรยฎQรNยดรฒ*ยย}ยต9ยณยAรฌรรUยTaรฑยรดยช'ย5jรถรครด>รรId01	:รยรฒยงjยยบeo?QยHรรจ0Mรขรปr$รยH]รฟยถยป=รรท[[ย(	xยฌfยรรยยชlร<ร)MรงOยฅรรขnยSยกiรยยพ!
รชร#Zยธยกรค ยoยญ\รญsรกef `hoNรยฎQยรNยดรฒ*ยย}ยต9ยณยAรฌรรUยTaรฑยรดยช'ย5jรถรครด>รรId01	:รยรฒยงjยยบeo?QยHรรจ0Mรขรปr$รยH]รฟยถยป=รรท[[ย(	xยฌfยรรยยชlร<ร)MรงOยฅรรขnยSยกiรยยพ!
รชร#Zยธยกรค ยoยญ\รญsรกef `hoNรยฎQยNรNยดรฒ*ยย}ยต9ยณยAรฌรรUยTaรฑยรดยช'ย5jรถรครด>รรId01	:รยรฒยงjยยบeo?QยHรรจ0Mรขรปr$รยH]รฟยถยป=รรท[[ย(	xยฌfยรรยยชlร<ร)MรงOยฅรรขnยSยกiรยยพ!
รชร#Zยธยกรค ยoยญ\รญsรกef `hoNรยฎQยNpรNยดรฒ*ยย}ยต9ยณยAรฌรรUยTaรฑยรดยช'ย5jรถรครด>รรId01	:รยรฒยงjยยบeo?QยHรรจ0Mรขรปr$รยH]รฟยถยป=รรท[[ย(	xยฌfยรรยยชlร<ร)MรงOยฅรรขnยSยกiรยยพ!
รชร#Zยธยกรค ยoยญ\รญsรกef `hoNรยฎQยNpยฟรNยดรฒ*ยย}ยต9ยณยAรฌรรUยTaรฑยรดยช'ย5jรถรครด>รรId01	:รยรฒยงjยยบeo?QยHรรจ0Mรขรปr$รยH]รฟยถยป=รรท[[ย(	xยฌfยรรยยชlร<ร)MรงOยฅรรขnยSยกiรยยพ!
รชร#Zยธยกรค ยoยญ\รญsรกef `hoNรยฎQยNpยฟรรNยดรฒ*ยย}ยต9ยณยAรฌรรUยTaรฑยรดยช'ย5jรถรครด>รรId01	:รยรฒยงjยยบeo?QยHรรจ0Mรขรปr$รยH]รฟยถยป=รรท[[ย(	xยฌfยรรยยชlร<ร)MรงOยฅรรขnยSยกiรยยพ!
รชร#Zยธยกรค ยoยญ\รญsรกef `hoNรยฎQยNpยฟร`รNยดรฒ*ยย}ยต9ยณยAรฌรรUยTaรฑยรดยช'ย5jรถรครด>รรId01	:รยรฒยงjยยบeo?QยHรรจ0Mรขรปr$รยH]รฟยถยป=รรท[[ย(	xยฌfยรรยยชlร<ร)MรงOยฅรรขnยSยกiรยยพ!
รชร#Zยธยกรค ยoยญ\รญsรกef `hoNรยฎQยNpยฟร`	รNยดรฒ*ยย}ยต9ยณยAรฌรรUยTaรฑยรดยช'ย5jรถรครด>รรId01	:รยรฒยงjยยบeo?QยHรรจ0Mรขรปr$รยH]รฟยถยป=รรท[[ย(	xยฌfยรรยยชlร<ร)MรงOยฅรรขnยSยกiรยยพ!
รชร#Zยธยกรค ยoยญ\รญsรกef `hoNรยฎQยNpยฟร`	รรNยดรฒ*ยย}ยต9ยณยAรฌรรUยTaรฑยรดยช'ย5jรถรครด>รรId01	:รยรฒยงjยยบeo?QยHรรจ0Mรขรปr$รยH]รฟยถยป=รรท[[ย(	xยฌfยรรยยชlร<ร)MรงOยฅรรขnยSยกiรยยพ!
รชร#Zยธยกรค ยoยญ\รญsรกef `hoNรยฎQยNpยฟร`	รรNยดรฒ*ยย}ยต9ยณยAรฌรรUยTaรฑยรดยช'ย5jรถรครด>รรId01	:รยรฒยงjยยบeo?QยHรรจ0Mรขรปr$รยH]รฟยถยป=รรท[[ย(	xยฌfยรรยยชlร<ร)MรงOยฅรรขnยSยกiรยยพ!
รชร#Zยธยกรค ยoยญ\รญsรกef `hoNรยฎQยNpยฟร`	รmรNยดรฒ*ยย}ยต9ยณยAรฌรรUยTaรฑยรดยช'ย5jรถรครด>รรId01	:รยรฒยงjยยบeo?QยHรรจ0Mรขรปr$รยH]รฟยถยป=รรท[[ย(	xยฌfยรรยยชlร<ร)MรงOยฅรรขnยSยกiรยยพ!
รชร#Zยธยกรค ยoยญ\รญsรกef `hoNรยฎQยNpยฟร`	รmรรNยดรฒ*ยย}ยต9ยณยAรฌรรUยTaรฑยรดยช'ย5jรถรครด>รรId01	:รยรฒยงjยยบeo?QยHรรจ0Mรขรปr$รยH]รฟยถยป=รรท[[ย(	xยฌfยรรยยชlร<ร)MรงOยฅรรขnยSยกiรยยพ!
รชร#Zยธยกรค ยoยญ\รญsรกef `hoNรยฎQยNpยฟร`	รmรยฟรNยดรฒ*ยย}ยต9ยณยAรฌรรUยTaรฑยรดยช'ย5jรถรครด>รรId01	:รยรฒยงjยยบeo?QยHรรจ0Mรขรปr$รยH]รฟยถยป=รรท[[ย(	xยฌfยรรยยชlร<ร)MรงOยฅรรขnยSยกiรยยพ!
รชร#Zยธยกรค ยoยญ\รญsรกef `hoNรยฎQยNpยฟร`	รmรยฟรรNยดรฒ*ยย}ยต9ยณยAรฌรรUยTaรฑยรดยช'ย5jรถรครด>รรId01	:รยรฒยงjยยบeo?QยHรรจ0Mรขรปr$รยH]รฟยถยป=รรท[[ย(	xยฌfยรรยยชlร<ร)MรงOยฅรรขnยSยกiรยยพ!
รชร#Zยธยกรค ยoยญ\รญsรกef `hoNรยฎQยNpยฟร`	รmรยฟรรฒรNยดรฒ*ยย}ยต9ยณยAรฌรรUยTaรฑยรดยช'ย5jรถรครด>รรId01	:รยรฒยงjยยบeo?QยHรรจ0Mรขรปr$รยH]รฟยถยป=รรท[[ย(	xยฌfยรรยยชlร<ร)MรงOยฅรรขnยSยกiรยยพ!
รชร#Zยธยกรค ยoยญ\รญsรกef `hoNรยฎQยNpยฟร`	รmรยฟรรฒVรNยดรฒ*ยย}ยต9ยณยAรฌรรUยTaรฑยรดยช'ย5jรถรครด>รรId01	:รยรฒยงjยยบeo?QยHรรจ0Mรขรปr$รยH]รฟยถยป=รรท[[ย(	xยฌfยรรยยชlร<ร)MรงOยฅรรขnยSยกiรยยพ!
รชร#Zยธยกรค ยoยญ\รญsรกef `hoNรยฎQยNpยฟร`	รmรยฟรรฒVรนรNยดรฒ*ยย}ยต9ยณยAรฌรรUยTaรฑยรดยช'ย5jรถรครด>รรId01	:รยรฒยงjยยบeo?QยHรรจ0Mรขรปr$รยH]รฟยถยป=รรท[[ย(	xยฌfยรรยยชlร<ร)MรงOยฅรรขnยSยกiรยยพ!
รชร#Zยธยกรค ยoยญ\รญsรกef `hoNรยฎQยNpยฟร`	รmรยฟรรฒVรนรรNยดรฒ*ยย}ยต9ยณยAรฌรรUยTaรฑยรดยช'ย5jรถรครด>รรId01	:รยรฒยงjยยบeo?QยHรรจ0Mรขรปr$รยH]รฟยถยป=รรท[[ย(	xยฌfยรรยยชlร<ร)MรงOยฅรรขnยSยกiรยยพ!
รชร#Zยธยกรค ยoยญ\รญsรกef `hoNรยฎQยNpยฟร`	รmรยฟรรฒVรนรรรNยดรฒ*ยย}ยต9ยณยAรฌรรUยTaรฑยรดยช'ย5jรถรครด>รรId01	:รยรฒยงjยยบeo?QยHรรจ0Mรขรปr$รยH]รฟยถยป=รรท[[ย(	xยฌfยรรยยชlร<ร)MรงOยฅรรขnยSยกiรยยพ!
รชร#Zยธยกรค ยoยญ\รญsรกef `hoNรยฎQยNpยฟร`	รmรยฟรรฒVรนรรยฏรNยดรฒ*ยย}ยต9ยณยAรฌรรUยTaรฑยรดยช'ย5jรถรครด>รรId01	:รยรฒยงjยยบeo?QยHรรจ0Mรขรปr$รยH]รฟยถยป=รรท[[ย(	xยฌfยรรยยชlร<ร)MรงOยฅรรขnยSยกiรยยพ!
รชร#Zยธยกรค ยoยญ\รญsรกef `hoNรยฎQยNpยฟร`	รmรยฟรรฒVรนรรยฏยรNยดรฒ*ยย}ยต9ยณยAรฌรรUยTaรฑยรดยช'ย5jรถรครด>รรId01	:รยรฒยงjยยบeo?QยHรรจ0Mรขรปr$รยH]รฟยถยป=รรท[[ย(	xยฌfยรรยยชlร<ร)MรงOยฅรรขnยSยกiรยยพ!
รชร#Zยธยกรค ยoยญ\รญsรกef `hoNรยฎQยNpยฟร`	รmรยฟรรฒVรนรรยฏยรNยดรฒ*ยย}ยต9ยณยAรฌรรUยTaรฑยรดยช'ย5jรถรครด>รรId01	:รยรฒยงjยยบeo?QยHรรจ0Mรขรปr$รยH]รฟยถยป=รรท[[ย(	xยฌfยรรยยชlร<ร)MรงOยฅรรขnยSยกiรยยพ!
รชร#Zยธยกรค ยoยญ\รญsรกef `hoNรยฎQยNpยฟร`	รmรยฟรรฒVรนรรยฏย;รNยดรฒ*ยย}ยต9ยณยAรฌรรUยTaรฑยรดยช'ย5jรถรครด>รรId01	:รยรฒยงjยยบeo?QยHรรจ0Mรขรปr$รยH]รฟยถยป=รรท[[ย(	xยฌfยรรยยชlร<ร)MรงOยฅรรขnยSยกiรยยพ!
รชร#Zยธยกรค ยoยญ\รญsรกef `hoNรยฎQยNpยฟร`	รmรยฟรรฒVรนรรยฏย;รรNยดรฒ*ยย}ยต9ยณยAรฌรรUยTaรฑยรดยช'ย5jรถรครด>รรId01	:รยรฒยงjยยบeo?QยHรรจ0Mรขรปr$รยH]รฟยถยป=รรท[[ย(	xยฌfยรรยยชlร<ร)MรงOยฅรรขnยSยกiรยยพ!
รชร#Zยธยกรค ยoยญ\รญsรกef `hoNรยฎQยNpยฟร`	รmรยฟรรฒVรนรรยฏย;รkรNยดรฒ*ยย}ยต9ยณยAรฌรรUยTaรฑยรดยช'ย5jรถรครด>รรId01	:รยรฒยงjยยบeo?QยHรรจ0Mรขรปr$รยH]รฟยถยป=รรท[[ย(	xยฌfยรรยยชlร<ร)MรงOยฅรรขnยSยกiรยยพ!
รชร#Zยธยกรค ยoยญ\รญsรกef `hoNรยฎQยNpยฟร`	รmรยฟรรฒVรนรรยฏย;รkยครNยดรฒ*ยย}ยต9ยณยAรฌรรUยTaรฑยรดยช'ย5jรถรครด>รรId01	:รยรฒยงjยยบeo?QยHรรจ0Mรขรปr$รยH]รฟยถยป=รรท[[ย(	xยฌfยรรยยชlร<ร)MรงOยฅรรขnยSยกiรยยพ!
รชร#Zยธยกรค ยoยญ\รญsรกef `hoNรยฎQยNpยฟร`	รmรยฟรรฒVรนรรยฏย;รkยครฌรNยดรฒ*ยย}ยต9ยณยAรฌรรUยTaรฑยรดยช'ย5jรถรครด>รรId01	:รยรฒยงjยยบeo?QยHรรจ0Mรขรปr$รยH]รฟยถยป=รรท[[ย(	xยฌfยรรยยชlร<ร)MรงOยฅรรขnยSยกiรยยพ!
รชร#Zยธยกรค ยoยญ\รญsรกef `hoNรยฎQยNpยฟร`	รmรยฟรรฒVรนรรยฏย;รkยครฌรNยดรฒ*ยย}ยต9ยณยAรฌรรUยTaรฑยรดยช'ย5jรถรครด>รรId01	:รยรฒยงjยยบeo?QยHรรจ0Mรขรปr$รยH]รฟยถยป=รรท[[ย(	xยฌfยรรยยชlร<ร)MรงOยฅรรขnยSยกiรยยพ!
รชร#Zยธยกรค ยoยญ\รญsรกef `hoNรยฎQยNpยฟร`	รmรยฟรรฒVรนรรยฏย;รkยครฌยรNยดรฒ*ยย}ยต9ยณยAรฌรรUยTaรฑยรดยช'ย5jรถรครด>รรId01	:รยรฒยงjยยบeo?QยHรรจ0Mรขรปr$รยH]รฟยถยป=รรท[[ย(	xยฌfยรรยยชlร<ร)MรงOยฅรรขnยSยกiรยยพ!
รชร#Zยธยกรค ยoยญ\รญsรกef `hoNรยฎQยNpยฟร`	รmรยฟรรฒVรนรรยฏย;รkยครฌยรรNยดรฒ*ยย}ยต9ยณยAรฌรรUยTaรฑยรดยช'ย5jรถรครด>รรId01	:รยรฒยงjยยบeo?QยHรรจ0Mรขรปr$รยH]รฟยถยป=รรท[[ย(	xยฌfยรรยยชlร<ร)MรงOยฅรรขnยSยกiรยยพ!
รชร#Zยธยกรค ยoยญ\รญsรกef `hoNรยฎQยNpยฟร`	รmรยฟรรฒVรนรรยฏย;รkยครฌยร7รNยดรฒ*ยย}ยต9ยณยAรฌรรUยTaรฑยรดยช'ย5jรถรครด>รรId01	:รยรฒยงjยยบeo?QยHรรจ0Mรขรปr$รยH]รฟยถยป=รรท[[ย(	xยฌfยรรยยชlร<ร)MรงOยฅรรขnยSยกiรยยพ!
รชร#Zยธยกรค ยoยญ\รญsรกef `hoNรยฎQยNpยฟร`	รmรยฟรรฒVรนรรยฏย;รkยครฌยร7
รNยดรฒ*ยย}ยต9ยณยAรฌรรUยTaรฑยรดยช'ย5jรถรครด>รรId01	:รยรฒยงjยยบeo?QยHรรจ0Mรขรปr$รยH]รฟยถยป=รรท[[ย(	xยฌfยรรยยชlร<ร)MรงOยฅรรขnยSยกiรยยพ!
รชร#Zยธยกรค ยoยญ\รญsรกef `hoNรยฎQยNpยฟร`	รmรยฟรรฒVรนรรยฏย;รkยครฌยร7
รNยดรฒ*ยย}ยต9ยณยAรฌรรUยTaรฑยรดยช'ย5jรถรครด>รรId01	:รยรฒยงjยยบeo?QยHรรจ0Mรขรปr$รยH]รฟยถยป=รรท[[ย(	xยฌfยรรยยชlร<ร)MรงOยฅรรขnยSยกiรยยพ!
รชร#Zยธยกรค ยoยญ\รญsรกef `hoNรยฎQยNpยฟร`	รmรยฟรรฒVรนรรยฏย;รkยครฌยร7
qรNยดรฒ*ยย}ยต9ยณยAรฌรรUยTaรฑยรดยช'ย5jรถรครด>รรId01	:รยรฒยงjยยบeo?QยHรรจ0Mรขรปr$รยH]รฟยถยป=รรท[[ย(	xยฌfยรรยยชlร<ร)MรงOยฅรรขnยSยกiรยยพ!
รชร#Zยธยกรค ยoยญ\รญsรกef `hoNรยฎQยNpยฟร`	รmรยฟรรฒVรนรรยฏย;รkยครฌยร7
qยตรNยดรฒ*ยย}ยต9ยณยAรฌรรUยTaรฑยรดยช'ย5jรถรครด>รรId01	:รยรฒยงjยยบeo?QยHรรจ0Mรขรปr$รยH]รฟยถยป=รรท[[ย(	xยฌfยรรยยชlร<ร)MรงOยฅรรขnยSยกiรยยพ!
รชร#Zยธยกรค ยoยญ\รญsรกef `hoNรยฎQยNpยฟร`	รmรยฟรรฒVรนรรยฏย;รkยครฌยร7
qยต!รNยดรฒ*ยย}ยต9ยณยAรฌรรUยTaรฑยรดยช'ย5jรถรครด>รรId01	:รยรฒยงjยยบeo?QยHรรจ0Mรขรปr$รยH]รฟยถยป=รรท[[ย(	xยฌfยรรยยชlร<ร)MรงOยฅรรขnยSยกiรยยพ!
รชร#Zยธยกรค ยoยญ\รญsรกef `hoNรยฎQยNpยฟร`	รmรยฟรรฒVรนรรยฏย;รkยครฌยร7
qยต!ยฉรNยดรฒ*ยย}ยต9ยณยAรฌรรUยTaรฑยรดยช'ย5jรถรครด>รรId01	:รยรฒยงjยยบeo?QยHรรจ0Mรขรปr$รยH]รฟยถยป=รรท[[ย(	xยฌfยรรยยชlร<ร)MรงOยฅรรขnยSยกiรยยพ!
รชร#Zยธยกรค ยoยญ\รญsรกef `hoNรยฎQยNpยฟร`	รmรยฟรรฒVรนรรยฏย;รkยครฌยร7
qยต!ยฉรกรNยดรฒ*ยย}ยต9ยณยAรฌรรUยTaรฑยรดยช'ย5jรถรครด>รรId01	:รยรฒยงjยยบeo?QยHรรจ0Mรขรปr$รยH]รฟยถยป=รรท[[ย(	xยฌfยรรยยชlร<ร)MรงOยฅรรขnยSยกiรยยพ!
รชร#Zยธยกรค ยoยญ\รญsรกef `hoNรยฎQยNpยฟร`	รmรยฟรรฒVรนรรยฏย;รkยครฌยร7
qยต!ยฉรกรรNยดรฒ*ยย}ยต9ยณยAรฌรรUยTaรฑยรดยช'ย5jรถรครด>รรId01	:รยรฒยงjยยบeo?QยHรรจ0Mรขรปr$รยH]รฟยถยป=รรท[[ย(	xยฌfยรรยยชlร<ร)MรงOยฅรรขnยSยกiรยยพ!
รชร#Zยธยกรค ยoยญ\รญsรกef `hoNรยฎQยNpยฟร`	รmรยฟรรฒVรนรรยฏย;รkยครฌยร7
qยต!ยฉรกรยรNยดรฒ*ยย}ยต9ยณยAรฌรรUยTaรฑยรดยช'ย5jรถรครด>รรId01	:รยรฒยงjยยบeo?QยHรรจ0Mรขรปr$รยH]รฟยถยป=รรท[[ย(	xยฌfยรรยยชlร<ร)MรงOยฅรรขnยSยกiรยยพ!
รชร#Zยธยกรค ยoยญ\รญsรกef `hoNรยฎQยNpยฟร`	รmรยฟรรฒVรนรรยฏย;รkยครฌยร7
qยต!ยฉรกรยยบรNยดรฒ*ยย}ยต9ยณยAรฌรรUยTaรฑยรดยช'ย5jรถรครด>รรId01	:รยรฒยงjยยบeo?QยHรรจ0Mรขรปr$รยH]รฟยถยป=รรท[[ย(	xยฌfยรรยยชlร<ร)MรงOยฅรรขnยSยกiรยยพ!
รชร#Zยธยกรค ยoยญ\รญsรกef `hoNรยฎQยNpยฟร`	รmรยฟรรฒVรนรรยฏย;รkยครฌยร7
qยต!ยฉรกรยยบzรNยดรฒ*ยย}ยต9ยณยAรฌรรUยTaรฑยรดยช'ย5jรถรครด>รรId01	:รยรฒยงjยยบeo?QยHรรจ0Mรขรปr$รยH]รฟยถยป=รรท[[ย(	xยฌfยรรยยชlร<ร)MรงOยฅรรขnยSยกiรยยพ!
รชร#Zยธยกรค ยoยญ\รญsรกef `hoNรยฎQยNpยฟร`	รmรยฟรรฒVรนรรยฏย;รkยครฌยร7
qยต!ยฉรกรยยบzยดรNยดรฒ*ยย}ยต9ยณยAรฌรรUยTaรฑยรดยช'ย5jรถรครด>รรId01	:รยรฒยงjยยบeo?QยHรรจ0Mรขรปr$รยH]รฟยถยป=รรท[[ย(	xยฌfยรรยยชlร<ร)MรงOยฅรรขnยSยกiรยยพ!
รชร#Zยธยกรค ยoยญ\รญsรกef `hoNรยฎQยNpยฟร`	รmรยฟรรฒVรนรรยฏย;รkยครฌยร7
qยต!ยฉรกรยยบzยดยฆรNยดรฒ*ยย}ยต9ยณยAรฌรรUยTaรฑยรดยช'ย5jรถรครด>รรId01	:รยรฒยงjยยบeo?QยHรรจ0Mรขรปr$รยH]รฟยถยป=รรท[[ย(	xยฌfยรรยยชlร<ร)MรงOยฅรรขnยSยกiรยยพ!
รชร#Zยธยกรค ยoยญ\รญsรกef `hoNรยฎQยNpยฟร`	รmรยฟรรฒVรนรรยฏย;รkยครฌยร7
qยต!ยฉรกรยยบzยดยฆรรNยดรฒ*ยย}ยต9ยณยAรฌรรUยTaรฑยรดยช'ย5jรถรครด>รรId01	:รยรฒยงjยยบeo?QยHรรจ0Mรขรปr$รยH]รฟยถยป=รรท[[ย(	xยฌfยรรยยชlร<ร)MรงOยฅรรขnยSยกiรยยพ!
รชร#Zยธยกรค ยoยญ\รญsรกef `hoNรยฎQยNpยฟร`	รmรยฟรรฒVรนรรยฏย;รkยครฌยร7
qยต!ยฉรกรยยบzยดยฆร]รNยดรฒ*ยย}ยต9ยณยAรฌรรUยTaรฑยรดยช'ย5jรถรครด>รรId01	:รยรฒยงjยยบeo?QยHรรจ0Mรขรปr$รยH]รฟยถยป=รรท[[ย(	xยฌfยรรยยชlร<ร)MรงOยฅรรขnยSยกiรยยพ!
รชร#Zยธยกรค ยoยญ\รญsรกef `hoNรยฎQยNpยฟร`	รmรยฟรรฒVรนรรยฏย;รkยครฌยร7
qยต!ยฉรกรยยบzยดยฆร]ยรNยดรฒ*ยย}ยต9ยณยAรฌรรUยTaรฑยรดยช'ย5jรถรครด>รรId01	:รยรฒยงjยยบeo?QยHรรจ0Mรขรปr$รยH]รฟยถยป=รรท[[ย(	xยฌfยรรยยชlร<ร)MรงOยฅรรขnยSยกiรยยพ!
รชร#Zยธยกรค ยoยญ\รญsรกef `hoNรยฎQยNpยฟร`	รmรยฟรรฒVรนรรยฏย;รkยครฌยร7
qยต!ยฉรกรยยบzยดยฆร]ยEรNยดรฒ*ยย}ยต9ยณยAรฌรรUยTaรฑยรดยช'ย5jรถรครด>รรId01	:รยรฒยงjยยบeo?QยHรรจ0Mรขรปr$รยH]รฟยถยป=รรท[[ย(	xยฌfยรรยยชlร<ร)MรงOยฅรรขnยSยกiรยยพ!
รชร#Zยธยกรค ยoยญ\รญsรกef `hoNรยฎQยNpยฟร`	รmรยฟรรฒVรนรรยฏย;รkยครฌยร7
qยต!ยฉรกรยยบzยดยฆร]ยE?รNยดรฒ*ยย}ยต9ยณยAรฌรรUยTaรฑยรดยช'ย5jรถรครด>รรId01	:รยรฒยงjยยบeo?QยHรรจ0Mรขรปr$รยH]รฟยถยป=รรท[[ย(	xยฌfยรรยยชlร<ร)MรงOยฅรรขnยSยกiรยยพ!
รชร#Zยธยกรค ยoยญ\รญsรกef `hoNรยฎQยNpยฟร`	รmรยฟรรฒVรนรรยฏย;รkยครฌยร7
qยต!ยฉรกรยยบzยดยฆร]ยE?IรNยดรฒ*ยย}ยต9ยณยAรฌรรUยTaรฑยรดยช'ย5jรถรครด>รรId01	:รยรฒยงjยยบeo?QยHรรจ0Mรขรปr$รยH]รฟยถยป=รรท[[ย(	xยฌfยรรยยชlร<ร)MรงOยฅรรขnยSยกiรยยพ!
รชร#Zยธยกรค ยoยญ\รญsรกef `hoNรยฎQยNpยฟร`	รmรยฟรรฒVรนรรยฏย;รkยครฌยร7
qยต!ยฉรกรยยบzยดยฆร]ยE?IรรNยดรฒ*ยย}ยต9ยณยAรฌรรUยTaรฑยรดยช'ย5jรถรครด>รรId01	:รยรฒยงjยยบeo?QยHรรจ0Mรขรปr$รยH]รฟยถยป=รรท[[ย(	xยฌfยรรยยชlร<ร)MรงOยฅรรขnยSยกiรยยพ!
รชร#Zยธยกรค ยoยญ\รญsรกef `hoNรยฎQยNpยฟร`	รmรยฟรรฒVรนรรยฏย;รkยครฌยร7
qยต!ยฉรกรยยบzยดยฆร]ยE?Iร{รNยดรฒ*ยย}ยต9ยณยAรฌรรUยTaรฑยรดยช'ย5jรถรครด>รรId01	:รยรฒยงjยยบeo?QยHรรจ0Mรขรปr$รยH]รฟยถยป=รรท[[ย(	xยฌfยรรยยชlร<ร)MรงOยฅรรขnยSยกiรยยพ!
รชร#Zยธยกรค ยoยญ\รญsรกef `hoNรยฎQยNpยฟร`	รmรยฟรรฒVรนรรยฏย;รkยครฌยร7
qยต!ยฉรกรยยบzยดยฆร]ยE?Iร{รฏรNยดรฒ*ยย}ยต9ยณยAรฌรรUยTaรฑยรดยช'ย5jรถรครด>รรId01	:รยรฒยงjยยบeo?QยHรรจ0Mรขรปr$รยH]รฟยถยป=รรท[[ย(	xยฌfยรรยยชlร<ร)MรงOยฅรรขnยSยกiรยยพ!
รชร#Zยธยกรค ยoยญ\รญsรกef `hoNรยฎQยNpยฟร`	รmรยฟรรฒVรนรรยฏย;รkยครฌยร7
qยต!ยฉรกรยยบzยดยฆร]ยE?Iร{รฏยรNยดรฒ*ยย}ยต9ยณยAรฌรรUยTaรฑยรดยช'ย5jรถรครด>รรId01	:รยรฒยงjยยบeo?QยHรรจ0Mรขรปr$รยH]รฟยถยป=รรท[[ย(	xยฌfยรรยยชlร<ร)MรงOยฅรรขnยSยกiรยยพ!
รชร#Zยธยกรค ยoยญ\รญsรกef `hoNรยฎQยNpยฟร`	รmรยฟรรฒVรนรรยฏย;รkยครฌยร7
qยต!ยฉรกรยยบzยดยฆร]ยE?Iร{รฏยรฆรNยดรฒ*ยย}ยต9ยณยAรฌรรUยTaรฑยรดยช'ย5jรถรครด>รรId01	:รยรฒยงjยยบeo?QยHรรจ0Mรขรปr$รยH]รฟยถยป=รรท[[ย(	xยฌfยรรยยชlร<ร)MรงOยฅรรขnยSยกiรยยพ!
รชร#Zยธยกรค ยoยญ\รญsรกef `hoNรยฎQยNpยฟร`	รmรยฟรรฒVรนรรยฏย;รkยครฌยร7
qยต!ยฉรกรยยบzยดยฆร]ยE?Iร{รฏยรฆรรNยดรฒ*ยย}ยต9ยณยAรฌรรUยTaรฑยรดยช'ย5jรถรครด>รรId01	:รยรฒยงjยยบeo?QยHรรจ0Mรขรปr$รยH]รฟยถยป=รรท[[ย(	xยฌfยรรยยชlร<ร)MรงOยฅรรขnยSยกiรยยพ!
รชร#Zยธยกรค ยoยญ\รญsรกef `hoNรยฎQยNpยฟร`	รmรยฟรรฒVรนรรยฏย;รkยครฌยร7
qยต!ยฉรกรยยบzยดยฆร]ยE?Iร{รฏยรฆรYรNยดรฒ*ยย}ยต9ยณยAรฌรรUยTaรฑยรดยช'ย5jรถรครด>รรId01	:รยรฒยงjยยบeo?QยHรรจ0Mรขรปr$รยH]รฟยถยป=รรท[[ย(	xยฌfยรรยยชlร<ร)MรงOยฅรรขnยSยกiรยยพ!
รชร#Zยธยกรค ยoยญ\รญsรกef `hoNรยฎQยNpยฟร`	รmรยฟรรฒVรนรรยฏย;รkยครฌยร7
qยต!ยฉรกรยยบzยดยฆร]ยE?Iร{รฏยรฆรYรรNยดรฒ*ยย}ยต9ยณยAรฌรรUยTaรฑยรดยช'ย5jรถรครด>รรId01	:รยรฒยงjยยบeo?QยHรรจ0Mรขรปr$รยH]รฟยถยป=รรท[[ย(	xยฌfยรรยยชlร<ร)MรงOยฅรรขnยSยกiรยยพ!
รชร#Zยธยกรค ยoยญ\รญsรกef `hoNรยฎQยNpยฟร`	รmรยฟรรฒVรนรรยฏย;รkยครฌยร7
qยต!ยฉรกรยยบzยดยฆร]ยE?Iร{รฏยรฆรYรยรNยดรฒ*ยย}ยต9ยณยAรฌรรUยTaรฑยรดยช'ย5jรถรครด>รรId01	:รยรฒยงjยยบeo?QยHรรจ0Mรขรปr$รยH]รฟยถยป=รรท[[ย(	xยฌfยรรยยชlร<ร)MรงOยฅรรขnยSยกiรยยพ!
รชร#Zยธยกรค ยoยญ\รญsรกef `hoNรยฎQยNpยฟร`	รmรยฟรรฒVรนรรยฏย;รkยครฌยร7
qยต!ยฉรกรยยบzยดยฆร]ยE?Iร{รฏยรฆรYรย<รNยดรฒ*ยย}ยต9ยณยAรฌรรUยTaรฑยรดยช'ย5jรถรครด>รรId01	:รยรฒยงjยยบeo?QยHรรจ0Mรขรปr$รยH]รฟยถยป=รรท[[ย(	xยฌfยรรยยชlร<ร)MรงOยฅรรขnยSยกiรยยพ!
รชร#Zยธยกรค ยoยญ\รญsรกef `hoNรยฎQยNpยฟร`	รmรยฟรรฒVรนรรยฏย;รkยครฌยร7
qยต!ยฉรกรยยบzยดยฆร]ยE?Iร{รฏยรฆรYรย<>รNยดรฒ*ยย}ยต9ยณยAรฌรรUยTaรฑยรดยช'ย5jรถรครด>รรId01	:รยรฒยงjยยบeo?QยHรรจ0Mรขรปr$รยH]รฟยถยป=รรท[[ย(	xยฌfยรรยยชlร<ร)MรงOยฅรรขnยSยกiรยยพ!
รชร#Zยธยกรค ยoยญ\รญsรกef `hoNรยฎQยNpยฟร`	รmรยฟรรฒVรนรรยฏย;รkยครฌยร7
qยต!ยฉรกรยยบzยดยฆร]ยE?Iร{รฏยรฆรYรย<>รฎรNยดรฒ*ยย}ยต9ยณยAรฌรรUยTaรฑยรดยช'ย5jรถรครด>รรId01	:รยรฒยงjยยบeo?QยHรรจ0Mรขรปr$รยH]รฟยถยป=รรท[[ย(	xยฌfยรรยยชlร<ร)MรงOยฅรรขnยSยกiรยยพ!
รชร#Zยธยกรค ยoยญ\รญsรกef `hoNรยฎQยNpยฟร`	รmรยฟรรฒVรนรรยฏย;รkยครฌยร7
qยต!ยฉรกรยยบzยดยฆร]ยE?Iร{รฏยรฆรYรย<>รฎ3รNยดรฒ*ยย}ยต9ยณยAรฌรรUยTaรฑยรดยช'ย5jรถรครด>รรId01	:รยรฒยงjยยบeo?QยHรรจ0Mรขรปr$รยH]รฟยถยป=รรท[[ย(	xยฌfยรรยยชlร<ร)MรงOยฅรรขnยSยกiรยยพ!
รชร#Zยธยกรค ยoยญ\รญsรกef `hoNรยฎQยNpยฟร`	รmรยฟรรฒVรนรรยฏย;รkยครฌยร7
qยต!ยฉรกรยยบzยดยฆร]ยE?Iร{รฏยรฆรYรย<>รฎ3ยฉรNยดรฒ*ยย}ยต9ยณยAรฌรรUยTaรฑยรดยช'ย5jรถรครด>รรId01	:รยรฒยงjยยบeo?QยHรรจ0Mรขรปr$รยH]รฟยถยป=รรท[[ย(	xยฌfยรรยยชlร<ร)MรงOยฅรรขnยSยกiรยยพ!
รชร#Zยธยกรค ยoยญ\รญsรกef `hoNรยฎQยNpยฟร`	รmรยฟรรฒVรนรรยฏย;รkยครฌยร7
qยต!ยฉรกรยยบzยดยฆร]ยE?Iร{รฏยรฆรYรย<>รฎ3ยฉHรNยดรฒ*ยย}ยต9ยณยAรฌรรUยTaรฑยรดยช'ย5jรถรครด>รรId01	:รยรฒยงjยยบeo?QยHรรจ0Mรขรปr$รยH]รฟยถยป=รรท[[ย(	xยฌfยรรยยชlร<ร)MรงOยฅรรขnยSยกiรยยพ!
รชร#Zยธยกรค ยoยญ\รญsรกef `hoNรยฎQยNpยฟร`	รmรยฟรรฒVรนรรยฏย;รkยครฌยร7
qยต!ยฉรกรยยบzยดยฆร]ยE?Iร{รฏยรฆรYรย<>รฎ3ยฉH=รNยดรฒ*ยย}ยต9ยณยAรฌรรUยTaรฑยรดยช'ย5jรถรครด>รรId01	:รยรฒยงjยยบeo?QยHรรจ0Mรขรปr$รยH]รฟยถยป=รรท[[ย(	xยฌfยรรยยชlร<ร)MรงOยฅรรขnยSยกiรยยพ!
รชร#Zยธยกรค ยoยญ\รญsรกef `hoNรยฎQยNpยฟร`	รmรยฟรรฒVรนรรยฏย;รkยครฌยร7
qยต!ยฉรกรยยบzยดยฆร]ยE?Iร{รฏยรฆรYรย<>รฎ3ยฉH=0รNยดรฒ*ยย}ยต9ยณยAรฌรรUยTaรฑยรดยช'ย5jรถรครด>รรId01	:รยรฒยงjยยบeo?QยHรรจ0Mรขรปr$รยH]รฟยถยป=รรท[[ย(	xยฌfยรรยยชlร<ร)MรงOยฅรรขnยSยกiรยยพ!
รชร#Zยธยกรค ยoยญ\รญsรกef `hoNรยฎQยNpยฟร`	รmรยฟรรฒVรนรรยฏย;รkยครฌยร7
qยต!ยฉรกรยยบzยดยฆร]ยE?Iร{รฏยรฆรYรย<>รฎ3ยฉH=0ยฌรNยดรฒ*ยย}ยต9ยณยAรฌรรUยTaรฑยรดยช'ย5jรถรครด>รรId01	:รยรฒยงjยยบeo?QยHรรจ0Mรขรปr$รยH]รฟยถยป=รรท[[ย(	xยฌfยรรยยชlร<ร)MรงOยฅรรขnยSยกiรยยพ!
รชร#Zยธยกรค ยoยญ\รญsรกef `hoNรยฎQยNpยฟร`	รmรยฟรรฒVรนรรยฏย;รkยครฌยร7
qยต!ยฉรกรยยบzยดยฆร]ยE?Iร{รฏยรฆรYรย<>รฎ3ยฉH=0ยฌยรNยดรฒ*ยย}ยต9ยณยAรฌรรUยTaรฑยรดยช'ย5jรถรครด>รรId01	:รยรฒยงjยยบeo?QยHรรจ0Mรขรปr$รยH]รฟยถยป=รรท[[ย(	xยฌfยรรยยชlร<ร)MรงOยฅรรขnยSยกiรยยพ!
รชร#Zยธยกรค ยoยญ\รญsรกef `hoNรยฎQยNpยฟร`	รmรยฟรรฒVรนรรยฏย;รkยครฌยร7
qยต!ยฉรกรยยบzยดยฆร]ยE?Iร{รฏยรฆรYรย<>รฎ3ยฉH=0ยฌยAรNยดรฒ*ยย}ยต9ยณยAรฌรรUยTaรฑยรดยช'ย5jรถรครด>รรId01	:รยรฒยงjยยบeo?QยHรรจ0Mรขรปr$รยH]รฟยถยป=รรท[[ย(	xยฌfยรรยยชlร<ร)MรงOยฅรรขnยSยกiรยยพ!
รชร#Zยธยกรค ยoยญ\รญsรกef `hoNรยฎQยNpยฟร`	รmรยฟรรฒVรนรรยฏย;รkยครฌยร7
qยต!ยฉรกรยยบzยดยฆร]ยE?Iร{รฏยรฆรYรย<>รฎ3ยฉH=0ยฌยAรรNยดรฒ*ยย}ยต9ยณยAรฌรรUยTaรฑยรดยช'ย5jรถรครด>รรId01	:รยรฒยงjยยบeo?QยHรรจ0Mรขรปr$รยH]รฟยถยป=รรท[[ย(	xยฌfยรรยยชlร<ร)MรงOยฅรรขnยSยกiรยยพ!
รชร#Zยธยกรค ยoยญ\รญsรกef `hoNรยฎQยNpยฟร`	รmรยฟรรฒVรนรรยฏย;รkยครฌยร7
qยต!ยฉรกรยยบzยดยฆร]ยE?Iร{รฏยรฆรYรย<>รฎ3ยฉH=0ยฌยAรยณรNยดรฒ*ยย}ยต9ยณยAรฌรรUยTaรฑยรดยช'ย5jรถรครด>รรId01	:รยรฒยงjยยบeo?QยHรรจ0Mรขรปr$รยH]รฟยถยป=รรท[[ย(	xยฌfยรรยยชlร<ร)MรงOยฅรรขnยSยกiรยยพ!
รชร#Zยธยกรค ยoยญ\รญsรกef `hoNรยฎQยNpยฟร`	รmรยฟรรฒVรนรรยฏย;รkยครฌยร7
qยต!ยฉรกรยยบzยดยฆร]ยE?Iร{รฏยรฆรYรย<>รฎ3ยฉH=0ยฌยAรยณรรNยดรฒ*ยย}ยต9ยณยAรฌรรUยTaรฑยรดยช'ย5jรถรครด>รรId01	:รยรฒยงjยยบeo?QยHรรจ0Mรขรปr$รยH]รฟยถยป=รรท[[ย(	xยฌfยรรยยชlร<ร)MรงOยฅรรขnยSยกiรยยพ!
รชร#Zยธยกรค ยoยญ\รญsรกef `hoNรยฎQยNpยฟร`	รmรยฟรรฒVรนรรยฏย;รkยครฌยร7
qยต!ยฉรกรยยบzยดยฆร]ยE?Iร{รฏยรฆรYรย<>รฎ3ยฉH=0ยฌยAรยณรยรNยดรฒ*ยย}ยต9ยณยAรฌรรUยTaรฑยรดยช'ย5jรถรครด>รรId01	:รยรฒยงjยยบeo?QยHรรจ0Mรขรปr$รยH]รฟยถยป=รรท[[ย(	xยฌfยรรยยชlร<ร)MรงOยฅรรขnยSยกiรยยพ!
รชร#Zยธยกรค ยoยญ\รญsรกef `hoNรยฎQยNpยฟร`	รmรยฟรรฒVรนรรยฏย;รkยครฌยร7
qยต!ยฉรกรยยบzยดยฆร]ยE?Iร{รฏยรฆรYรย<>รฎ3ยฉH=0ยฌยAรยณรย=รNยดรฒ*ยย}ยต9ยณยAรฌรรUยTaรฑยรดยช'ย5jรถรครด>รรId01	:รยรฒยงjยยบeo?QยHรรจ0Mรขรปr$รยH]รฟยถยป=รรท[[ย(	xยฌfยรรยยชlร<ร)MรงOยฅรรขnยSยกiรยยพ!
รชร#Zยธยกรค ยoยญ\รญsรกef `hoNรยฎQยNpยฟร`	รmรยฟรรฒVรนรรยฏย;รkยครฌยร7
qยต!ยฉรกรยยบzยดยฆร]ยE?Iร{รฏยรฆรYรย<>รฎ3ยฉH=0ยฌยAรยณรย=ยรNยดรฒ*ยย}ยต9ยณยAรฌรรUยTaรฑยรดยช'ย5jรถรครด>รรId01	:รยรฒยงjยยบeo?QยHรรจ0Mรขรปr$รยH]รฟยถยป=รรท[[ย(	xยฌfยรรยยชlร<ร)MรงOยฅรรขnยSยกiรยยพ!
รชร#Zยธยกรค ยoยญ\รญsรกef `hoNรยฎQยNpยฟร`	รmรยฟรรฒVรนรรยฏย;รkยครฌยร7
qยต!ยฉรกรยยบzยดยฆร]ยE?Iร{รฏยรฆรYรย<>รฎ3ยฉH=0ยฌยAรยณรย=ยยรNยดรฒ*ยย}ยต9ยณยAรฌรรUยTaรฑยรดยช'ย5jรถรครด>รรId01	:รยรฒยงjยยบeo?QยHรรจ0Mรขรปr$รยH]รฟยถยป=รรท[[ย(	xยฌfยรรยยชlร<ร)MรงOยฅรรขnยSยกiรยยพ!
รชร#Zยธยกรค ยoยญ\รญsรกef `hoNรยฎQยNpยฟร`	รmรยฟรรฒVรนรรยฏย;รkยครฌยร7
qยต!ยฉรกรยยบzยดยฆร]ยE?Iร{รฏยรฆรYรย<>รฎ3ยฉH=0ยฌยAรยณรย=ยย(รNยดรฒ*ยย}ยต9ยณยAรฌรรUยTaรฑยรดยช'ย5jรถรครด>รรId01	:รยรฒยงjยยบeo?QยHรรจ0Mรขรปr$รยH]รฟยถยป=รรท[[ย(	xยฌfยรรยยชlร<ร)MรงOยฅรรขnยSยกiรยยพ!
รชร#Zยธยกรค ยoยญ\รญsรกef `hoNรยฎQยNpยฟร`	รmรยฟรรฒVรนรรยฏย;รkยครฌยร7
qยต!ยฉรกรยยบzยดยฆร]ยE?Iร{รฏยรฆรYรย<>รฎ3ยฉH=0ยฌยAรยณรย=ยย(ยธรNยดรฒ*ยย}ยต9ยณยAรฌรรUยTaรฑยรดยช'ย5jรถรครด>รรId01	:รยรฒยงjยยบeo?QยHรรจ0Mรขรปr$รยH]รฟยถยป=รรท[[ย(	xยฌfยรรยยชlร<ร)MรงOยฅรรขnยSยกiรยยพ!
รชร#Zยธยกรค ยoยญ\รญsรกef `hoNรยฎQยNpยฟร`	รmรยฟรรฒVรนรรยฏย;รkยครฌยร7
qยต!ยฉรกรยยบzยดยฆร]ยE?Iร{รฏยรฆรYรย<>รฎ3ยฉH=0ยฌยAรยณรย=ยย(ยธรNยดรฒ*ยย}ยต9ยณยAรฌรรUยTaรฑยรดยช'ย5jรถรครด>รรId01	:รยรฒยงjยยบeo?QยHรรจ0Mรขรปr$รยH]รฟยถยป=รรท[[ย(	xยฌfยรรยยชlร<ร)MรงOยฅรรขnยSยกiรยยพ!
รชร#Zยธยกรค ยoยญ\รญsรกef `hoNรยฎQยNpยฟร`	รmรยฟรรฒVรนรรยฏย;รkยครฌยร7
qยต!ยฉรกรยยบzยดยฆร]ยE?Iร{รฏยรฆรYรย<>รฎ3ยฉH=0ยฌยAรยณรย=ยย(ยธรรNยดรฒ*ยย}ยต9ยณยAรฌรรUยTaรฑยรดยช'ย5jรถรครด>รรId01	:รยรฒยงjยยบeo?QยHรรจ0Mรขรปr$รยH]รฟยถยป=รรท[[ย(	xยฌfยรรยยชlร<ร)MรงOยฅรรขnยSยกiรยยพ!
รชร#Zยธยกรค ยoยญ\รญsรกef `hoNรยฎQยNpยฟร`	รmรยฟรรฒVรนรรยฏย;รkยครฌยร7
qยต!ยฉรกรยยบzยดยฆร]ยE?Iร{รฏยรฆรYรย<>รฎ3ยฉH=0ยฌยAรยณรย=ยย(ยธรรNยดรฒ*ยย}ยต9ยณยAรฌรรUยTaรฑยรดยช'ย5jรถรครด>รรId01	:รยรฒยงjยยบeo?QยHรรจ0Mรขรปr$รยH]รฟยถยป=รรท[[ย(	xยฌfยรรยยชlร<ร)MรงOยฅรรขnยSยกiรยยพ!
รชร#Zยธยกรค ยoยญ\รญsรกef `hoNรยฎQยNpยฟร`	รmรยฟรรฒVรนรรยฏย;รkยครฌยร7
qยต!ยฉรกรยยบzยดยฆร]ยE?Iร{รฏยรฆรYรย<>รฎ3ยฉH=0ยฌยAรยณรย=ยย(ยธรQรNยดรฒ*ยย}ยต9ยณยAรฌรรUยTaรฑยรดยช'ย5jรถรครด>รรId01	:รยรฒยงjยยบeo?QยHรรจ0Mรขรปr$รยH]รฟยถยป=รรท[[ย(	xยฌfยรรยยชlร<ร)MรงOยฅรรขnยSยกiรยยพ!
รชร#Zยธยกรค ยoยญ\รญsรกef `hoNรยฎQยNpยฟร`	รmรยฟรรฒVรนรรยฏย;รkยครฌยร7
qยต!ยฉรกรยยบzยดยฆร]ยE?Iร{รฏยรฆรYรย<>รฎ3ยฉH=0ยฌยAรยณรย=ยย(ยธรQรรNยดรฒ*ยย}ยต9ยณยAรฌรรUยTaรฑยรดยช'ย5jรถรครด>รรId01	:รยรฒยงjยยบeo?QยHรรจ0Mรขรปr$รยH]รฟยถยป=รรท[[ย(	xยฌfยรรยยชlร<ร)MรงOยฅรรขnยSยกiรยยพ!
รชร#Zยธยกรค ยoยญ\รญsรกef `hoNรยฎQยNpยฟร`	รmรยฟรรฒVรนรรยฏย;รkยครฌยร7
qยต!ยฉรกรยยบzยดยฆร]ยE?Iร{รฏยรฆรYรย<>รฎ3ยฉH=0ยฌยAรยณรย=ยย(ยธรQรรถรNยดรฒ*ยย}ยต9ยณยAรฌรรUยTaรฑยรดยช'ย5jรถรครด>รรId01	:รยรฒยงjยยบeo?QยHรรจ0Mรขรปr$รยH]รฟยถยป=รรท[[ย(	xยฌfยรรยยชlร<ร)MรงOยฅรรขnยSยกiรยยพ!
รชร#Zยธยกรค ยoยญ\รญsรกef `hoNรยฎQยNpยฟร`	รmรยฟรรฒVรนรรยฏย;รkยครฌยร7
qยต!ยฉรกรยยบzยดยฆร]ยE?Iร{รฏยรฆรYรย<>รฎ3ยฉH=0ยฌยAรยณรย=ยย(ยธรQรรถยรNยดรฒ*ยย}ยต9ยณยAรฌรรUยTaรฑยรดยช'ย5jรถรครด>รรId01	:รยรฒยงjยยบeo?QยHรรจ0Mรขรปr$รยH]รฟยถยป=รรท[[ย(	xยฌfยรรยยชlร<ร)MรงOยฅรรขnยSยกiรยยพ!
รชร#Zยธยกรค ยoยญ\รญsรกef `hoNรยฎQยNpยฟร`	รmรยฟรรฒVรนรรยฏย;รkยครฌยร7
qยต!ยฉรกรยยบzยดยฆร]ยE?Iร{รฏยรฆรYรย<>รฎ3ยฉH=0ยฌยAรยณรย=ยย(ยธรQรรถยยรNยดรฒ*ยย}ยต9ยณยAรฌรรUยTaรฑยรดยช'ย5jรถรครด>รรId01	:รยรฒยงjยยบeo?QยHรรจ0Mรขรปr$รยH]รฟยถยป=รรท[[ย(	xยฌfยรรยยชlร<ร)MรงOยฅรรขnยSยกiรยยพ!
รชร#Zยธยกรค ยoยญ\รญsรกef `hoNรยฎQยNpยฟร`	รmรยฟรรฒVรนรรยฏย;รkยครฌยร7
qยต!ยฉรกรยยบzยดยฆร]ยE?Iร{รฏยรฆรYรย<>รฎ3ยฉH=0ยฌยAรยณรย=ยย(ยธรQรรถยยรNยดรฒ*ยย}ยต9ยณยAรฌรรUยTaรฑยรดยช'ย5jรถรครด>รรId01	:รยรฒยงjยยบeo?QยHรรจ0Mรขรปr$รยH]รฟยถยป=รรท[[ย(	xยฌfยรรยยชlร<ร)MรงOยฅรรขnยSยกiรยยพ!
รชร#Zยธยกรค ยoยญ\รญsรกef `hoNรยฎQยNpยฟร`	รmรยฟรรฒVรนรรยฏย;รkยครฌยร7
qยต!ยฉรกรยยบzยดยฆร]ยE?Iร{รฏยรฆรYรย<>รฎ3ยฉH=0ยฌยAรยณรย=ยย(ยธรQรรถยยรรNยดรฒ*ยย}ยต9ยณยAรฌรรUยTaรฑยรดยช'ย5jรถรครด>รรId01	:รยรฒยงjยยบeo?QยHรรจ0Mรขรปr$รยH]รฟยถยป=รรท[[ย(	xยฌfยรรยยชlร<ร)MรงOยฅรรขnยSยกiรยยพ!
รชร#Zยธยกรค ยoยญ\รญsรกef `hoNรยฎQยNpยฟร`	รmรยฟรรฒVรนรรยฏย;รkยครฌยร7
qยต!ยฉรกรยยบzยดยฆร]ยE?Iร{รฏยรฆรYรย<>รฎ3ยฉH=0ยฌยAรยณรย=ยย(ยธรQรรถยยรยนรNยดรฒ*ยย}ยต9ยณยAรฌรรUยTaรฑยรดยช'ย5jรถรครด>รรId01	:รยรฒยงjยยบeo?QยHรรจ0Mรขรปr$รยH]รฟยถยป=รรท[[ย(	xยฌfยรรยยชlร<ร)MรงOยฅรรขnยSยกiรยยพ!
รชร#Zยธยกรค ยoยญ\รญsรกef `hoNรยฎQยNpยฟร`	รmรยฟรรฒVรนรรยฏย;รkยครฌยร7
qยต!ยฉรกรยยบzยดยฆร]ยE?Iร{รฏยรฆรYรย<>รฎ3ยฉH=0ยฌยAรยณรย=ยย(ยธรQรรถยยรยนUรNยดรฒ*ยย}ยต9ยณยAรฌรรUยTaรฑยรดยช'ย5jรถรครด>รรId01	:รยรฒยงjยยบeo?QยHรรจ0Mรขรปr$รยH]รฟยถยป=รรท[[ย(	xยฌfยรรยยชlร<ร)MรงOยฅรรขnยSยกiรยยพ!
รชร#Zยธยกรค ยoยญ\รญsรกef `hoNรยฎQยNpยฟร`	รmรยฟรรฒVรนรรยฏย;รkยครฌยร7
qยต!ยฉรกรยยบzยดยฆร]ยE?Iร{รฏยรฆรYรย<>รฎ3ยฉH=0ยฌยAรยณรย=ยย(ยธรQรรถยยรยนUรกรNยดรฒ*ยย}ยต9ยณยAรฌรรUยTaรฑยรดยช'ย5jรถรครด>รรId01	:รยรฒยงjยยบeo?QยHรรจ0Mรขรปr$รยH]รฟยถยป=รรท[[ย(	xยฌfยรรยยชlร<ร)MรงOยฅรรขnยSยกiรยยพ!
รชร#Zยธยกรค ยoยญ\รญsรกef `hoNรยฎQยNpยฟร`	รmรยฟรรฒVรนรรยฏย;รkยครฌยร7
qยต!ยฉรกรยยบzยดยฆร]ยE?Iร{รฏยรฆรYรย<>รฎ3ยฉH=0ยฌยAรยณรย=ยย(ยธรQรรถยยรยนUรกรงรNยดรฒ*ยย}ยต9ยณยAรฌรรUยTaรฑยรดยช'ย5jรถรครด>รรId01	:รยรฒยงjยยบeo?QยHรรจ0Mรขรปr$รยH]รฟยถยป=รรท[[ย(	xยฌfยรรยยชlร<ร)MรงOยฅรรขnยSยกiรยยพ!
รชร#Zยธยกรค ยoยญ\รญsรกef `hoNรยฎQยNpยฟร`	รmรยฟรรฒVรนรรยฏย;รkยครฌยร7
qยต!ยฉรกรยยบzยดยฆร]ยE?Iร{รฏยรฆรYรย<>รฎ3ยฉH=0ยฌยAรยณรย=ยย(ยธรQรรถยยรยนUรกรงรขรNยดรฒ*ยย}ยต9ยณยAรฌรรUยTaรฑยรดยช'ย5jรถรครด>รรId01	:รยรฒยงjยยบeo?QยHรรจ0Mรขรปr$รยH]รฟยถยป=รรท[[ย(	xยฌfยรรยยชlร<ร)MรงOยฅรรขnยSยกiรยยพ!
รชร#Zยธยกรค ยoยญ\รญsรกef `hoNรยฎQยNpยฟร`	รmรยฟรรฒVรนรรยฏย;รkยครฌยร7
qยต!ยฉรกรยยบzยดยฆร]ยE?Iร{รฏยรฆรYรย<>รฎ3ยฉH=0ยฌยAรยณรย=ยย(ยธรQรรถยยรยนUรกรงรขรพรNยดรฒ*ยย}ยต9ยณยAรฌรรUยTaรฑยรดยช'ย5jรถรครด>รรId01	:รยรฒยงjยยบeo?QยHรรจ0Mรขรปr$รยH]รฟยถยป=รรท[[ย(	xยฌfยรรยยชlร<ร)MรงOยฅรรขnยSยกiรยยพ!
รชร#Zยธยกรค ยoยญ\รญsรกef `hoNรยฎQยNpยฟร`	รmรยฟรรฒVรนรรยฏย;รkยครฌยร7
qยต!ยฉรกรยยบzยดยฆร]ยE?Iร{รฏยรฆรYรย<>รฎ3ยฉH=0ยฌยAรยณรย=ยย(ยธรQรรถยยรยนUรกรงรขรพwรNยดรฒ*ยย}ยต9ยณยAรฌรรUยTaรฑยรดยช'ย5jรถรครด>รรId01	:รยรฒยงjยยบeo?QยHรรจ0Mรขรปr$รยH]รฟยถยป=รรท[[ย(	xยฌfยรรยยชlร<ร)MรงOยฅรรขnยSยกiรยยพ!
รชร#Zยธยกรค ยoยญ\รญsรกef `hoNรยฎQยNpยฟร`	รmรยฟรรฒVรนรรยฏย;รkยครฌยร7
qยต!ยฉรกรยยบzยดยฆร]ยE?Iร{รฏยรฆรYรย<>รฎ3ยฉH=0ยฌยAรยณรย=ยย(ยธรQรรถยยรยนUรกรงรขรพw%รNยดรฒ*ยย}ยต9ยณยAรฌรรUยTaรฑยรดยช'ย5jรถรครด>รรId01	:รยรฒยงjยยบeo?QยHรรจ0Mรขรปr$รยH]รฟยถยป=รรท[[ย(	xยฌfยรรยยชlร<ร)MรงOยฅรรขnยSยกiรยยพ!
รชร#Zยธยกรค ยoยญ\รญsรกef `hoNรยฎQยNpยฟร`	รmรยฟรรฒVรนรรยฏย;รkยครฌยร7
qยต!ยฉรกรยยบzยดยฆร]ยE?Iร{รฏยรฆรYรย<>รฎ3ยฉH=0ยฌยAรยณรย=ยย(ยธรQรรถยยรยนUรกรงรขรพw%DรNยดรฒ*ยย}ยต9ยณยAรฌรรUยTaรฑยรดยช'ย5jรถรครด>รรId01	:รยรฒยงjยยบeo?QยHรรจ0Mรขรปr$รยH]รฟยถยป=รรท[[ย(	xยฌfยรรยยชlร<ร)MรงOยฅรรขnยSยกiรยยพ!
รชร#Zยธยกรค ยoยญ\รญsรกef `hoNรยฎQยNpยฟร`	รmรยฟรรฒVรนรรยฏย;รkยครฌยร7
qยต!ยฉรกรยยบzยดยฆร]ยE?Iร{รฏยรฆรYรย<>รฎ3ยฉH=0ยฌยAรยณรย=ยย(ยธรQรรถยยรยนUรกรงรขรพw%D1รNยดรฒ*ยย}ยต9ยณยAรฌรรUยTaรฑยรดยช'ย5jรถรครด>รรId01	:รยรฒยงjยยบeo?QยHรรจ0Mรขรปr$รยH]รฟยถยป=รรท[[ย(	xยฌfยรรยยชlร<ร)MรงOยฅรรขnยSยกiรยยพ!
รชร#Zยธยกรค ยoยญ\รญsรกef `hoNรยฎQยNpยฟร`	รmรยฟรรฒVรนรรยฏย;รkยครฌยร7
qยต!ยฉรกรยยบzยดยฆร]ยE?Iร{รฏยรฆรYรย<>รฎ3ยฉH=0ยฌยAรยณรย=ยย(ยธรQรรถยยรยนUรกรงรขรพw%D1~รNยดรฒ*ยย}ยต9ยณยAรฌรรUยTaรฑยรดยช'ย5jรถรครด>รรId01	:รยรฒยงjยยบeo?QยHรรจ0Mรขรปr$รยH]รฟยถยป=รรท[[ย(	xยฌfยรรยยชlร<ร)MรงOยฅรรขnยSยกiรยยพ!
รชร#Zยธยกรค ยoยญ\รญsรกef `hoNรยฎQยNpยฟร`	รmรยฟรรฒVรนรรยฏย;รkยครฌยร7
qยต!ยฉรกรยยบzยดยฆร]ยE?Iร{รฏยรฆรYรย<>รฎ3ยฉH=0ยฌยAรยณรย=ยย(ยธรQรรถยยรยนUรกรงรขรพw%D1~รNยดรฒ*ยย}ยต9ยณยAรฌรรUยTaรฑยรดยช'ย5jรถรครด>รรId01	:รยรฒยงjยยบeo?QยHรรจ0Mรขรปr$รยH]รฟยถยป=รรท[[ย(	xยฌfยรรยยชlร<ร)MรงOยฅรรขnยSยกiรยยพ!
รชร#Zยธยกรค ยoยญ\รญsรกef `hoNรยฎQยNpยฟร`	รmรยฟรรฒVรนรรยฏย;รkยครฌยร7
qยต!ยฉรกรยยบzยดยฆร]ยE?Iร{รฏยรฆรYรย<>รฎ3ยฉH=0ยฌยAรยณรย=ยย(ยธรQรรถยยรยนUรกรงรขรพw%D1~OรNยดรฒ*ยย}ยต9ยณยAรฌรรUยTaรฑยรดยช'ย5jรถรครด>รรId01	:รยรฒยงjยยบeo?QยHรรจ0Mรขรปr$รยH]รฟยถยป=รรท[[ย(	xยฌfยรรยยชlร<ร)MรงOยฅรรขnยSยกiรยยพ!
รชร#Zยธยกรค ยoยญ\รญsรกef `hoNรยฎQยNpยฟร`	รmรยฟรรฒVรนรรยฏย;รkยครฌยร7
qยต!ยฉรกรยยบzยดยฆร]ยE?Iร{รฏยรฆรYรย<>รฎ3ยฉH=0ยฌยAรยณรย=ยย(ยธรQรรถยยรยนUรกรงรขรพw%D1~OiรNยดรฒ*ยย}ยต9ยณยAรฌรรUยTaรฑยรดยช'ย5jรถรครด>รรId01	:รยรฒยงjยยบeo?QยHรรจ0Mรขรปr$รยH]รฟยถยป=รรท[[ย(	xยฌfยรรยยชlร<ร)MรงOยฅรรขnยSยกiรยยพ!
รชร#Zยธยกรค ยoยญ\รญsรกef `hoNรยฎQยNpยฟร`	รmรยฟรรฒVรนรรยฏย;รkยครฌยร7
qยต!ยฉรกรยยบzยดยฆร]ยE?Iร{รฏยรฆรYรย<>รฎ3ยฉH=0ยฌยAรยณรย=ยย(ยธรQรรถยยรยนUรกรงรขรพw%D1~OiรรNยดรฒ*ยย}ยต9ยณยAรฌรรUยTaรฑยรดยช'ย5jรถรครด>รรId01	:รยรฒยงjยยบeo?QยHรรจ0Mรขรปr$รยH]รฟยถยป=รรท[[ย(	xยฌfยรรยยชlร<ร)MรงOยฅรรขnยSยกiรยยพ!
รชร#Zยธยกรค ยoยญ\รญsรกef `hoNรยฎQยNpยฟร`	รmรยฟรรฒVรนรรยฏย;รkยครฌยร7
qยต!ยฉรกรยยบzยดยฆร]ยE?Iร{รฏยรฆรYรย<>รฎ3ยฉH=0ยฌยAรยณรย=ยย(ยธรQรรถยยรยนUรกรงรขรพw%D1~OiรยนรNยดรฒ*ยย}ยต9ยณยAรฌรรUยTaรฑยรดยช'ย5jรถรครด>รรId01	:รยรฒยงjยยบeo?QยHรรจ0Mรขรปr$รยH]รฟยถยป=รรท[[ย(	xยฌfยรรยยชlร<ร)MรงOยฅรรขnยSยกiรยยพ!
รชร#Zยธยกรค ยoยญ\รญsรกef `hoNรยฎQยNpยฟร`	รmรยฟรรฒVรนรรยฏย;รkยครฌยร7
qยต!ยฉรกรยยบzยดยฆร]ยE?Iร{รฏยรฆรYรย<>รฎ3ยฉH=0ยฌยAรยณรย=ยย(ยธรQรรถยยรยนUรกรงรขรพw%D1~Oiรยน)รNยดรฒ*ยย}ยต9ยณยAรฌรรUยTaรฑยรดยช'ย5jรถรครด>รรId01	:รยรฒยงjยยบeo?QยHรรจ0Mรขรปr$รยH]รฟยถยป=รรท[[ย(	xยฌfยรรยยชlร<ร)MรงOยฅรรขnยSยกiรยยพ!
รชร#Zยธยกรค ยoยญ\รญsรกef `hoNรยฎQยNpยฟร`	รmรยฟรรฒVรนรรยฏย;รkยครฌยร7
qยต!ยฉรกรยยบzยดยฆร]ยE?Iร{รฏยรฆรYรย<>รฎ3ยฉH=0ยฌยAรยณรย=ยย(ยธรQรรถยยรยนUรกรงรขรพw%D1~Oiรยน)ยพรNยดรฒ*ยย}ยต9ยณยAรฌรรUยTaรฑยรดยช'ย5jรถรครด>รรId01	:รยรฒยงjยยบeo?QยHรรจ0Mรขรปr$รยH]รฟยถยป=รรท[[ย(	xยฌfยรรยยชlร<ร)MรงOยฅรรขnยSยกiรยยพ!
รชร#Zยธยกรค ยoยญ\รญsรกef `hoNรยฎQยNpยฟร`	รmรยฟรรฒVรนรรยฏย;รkยครฌยร7
qยต!ยฉรกรยยบzยดยฆร]ยE?Iร{รฏยรฆรYรย<>รฎ3ยฉH=0ยฌยAรยณรย=ยย(ยธรQรรถยยรยนUรกรงรขรพw%D1~Oiรยน)ยพ<รNยดรฒ*ยย}ยต9ยณยAรฌรรUยTaรฑยรดยช'ย5jรถรครด>รรId01	:รยรฒยงjยยบeo?QยHรรจ0Mรขรปr$รยH]รฟยถยป=รรท[[ย(	xยฌfยรรยยชlร<ร)MรงOยฅรรขnยSยกiรยยพ!
รชร#Zยธยกรค ยoยญ\รญsรกef `hoNรยฎQยNpยฟร`	รmรยฟรรฒVรนรรยฏย;รkยครฌยร7
qยต!ยฉรกรยยบzยดยฆร]ยE?Iร{รฏยรฆรYรย<>รฎ3ยฉH=0ยฌยAรยณรย=ยย(ยธรQรรถยยรยนUรกรงรขรพw%D1~Oiรยน)ยพ<รครNยดรฒ*ยย}ยต9ยณยAรฌรรUยTaรฑยรดยช'ย5jรถรครด>รรId01	:รยรฒยงjยยบeo?QยHรรจ0Mรขรปr$รยH]รฟยถยป=รรท[[ย(	xยฌfยรรยยชlร<ร)MรงOยฅรรขnยSยกiรยยพ!
รชร#Zยธยกรค ยoยญ\รญsรกef `hoNรยฎQยNpยฟร`	รmรยฟรรฒVรนรรยฏย;รkยครฌยร7
qยต!ยฉรกรยยบzยดยฆร]ยE?Iร{รฏยรฆรYรย<>รฎ3ยฉH=0ยฌยAรยณรย=ยย(ยธรQรรถยยรยนUรกรงรขรพw%D1~Oiรยน)ยพ<รครNยดรฒ*ยย}ยต9ยณยAรฌรรUยTaรฑยรดยช'ย5jรถรครด>รรId01	:รยรฒยงjยยบeo?QยHรรจ0Mรขรปr$รยH]รฟยถยป=รรท[[ย(	xยฌfยรรยยชlร<ร)MรงOยฅรรขnยSยกiรยยพ!
รชร#Zยธยกรค ยoยญ\รญsรกef `hoNรยฎQยNpยฟร`	รmรยฟรรฒVรนรรยฏย;รkยครฌยร7
qยต!ยฉรกรยยบzยดยฆร]ยE?Iร{รฏยรฆรYรย<>รฎ3ยฉH=0ยฌยAรยณรย=ยย(ยธรQรรถยยรยนUรกรงรขรพw%D1~Oiรยน)ยพ<รคZรNยดรฒ*ยย}ยต9ยณยAรฌรรUยTaรฑยรดยช'ย5jรถรครด>รรId01	:รยรฒยงjยยบeo?QยHรรจ0Mรขรปr$รยH]รฟยถยป=รรท[[ย(	xยฌfยรรยยชlร<ร)MรงOยฅรรขnยSยกiรยยพ!
รชร#Zยธยกรค ยoยญ\รญsรกef `hoNรยฎQยNpยฟร`	รmรยฟรรฒVรนรรยฏย;รkยครฌยร7
qยต!ยฉรกรยยบzยดยฆร]ยE?Iร{รฏยรฆรYรย<>รฎ3ยฉH=0ยฌยAรยณรย=ยย(ยธรQรรถยยรยนUรกรงรขรพw%D1~Oiรยน)ยพ<รคZยนรNยดรฒ*ยย}ยต9ยณยAรฌรรUยTaรฑยรดยช'ย5jรถรครด>รรId01	:รยรฒยงjยยบeo?QยHรรจ0Mรขรปr$รยH]รฟยถยป=รรท[[ย(	xยฌfยรรยยชlร<ร)MรงOยฅรรขnยSยกiรยยพ!
รชร#Zยธยกรค ยoยญ\รญsรกef `hoNรยฎQยNpยฟร`	รmรยฟรรฒVรนรรยฏย;รkยครฌยร7
qยต!ยฉรกรยยบzยดยฆร]ยE?Iร{รฏยรฆรYรย<>รฎ3ยฉH=0ยฌยAรยณรย=ยย(ยธรQรรถยยรยนUรกรงรขรพw%D1~Oiรยน)ยพ<รคZยนยบรNยดรฒ*ยย}ยต9ยณยAรฌรรUยTaรฑยรดยช'ย5jรถรครด>รรId01	:รยรฒยงjยยบeo?QยHรรจ0Mรขรปr$รยH]รฟยถยป=รรท[[ย(	xยฌfยรรยยชlร<ร)MรงOยฅรรขnยSยกiรยยพ!
รชร#Zยธยกรค ยoยญ\รญsรกef `hoNรยฎQยNpยฟร`	รmรยฟรรฒVรนรรยฏย;รkยครฌยร7
qยต!ยฉรกรยยบzยดยฆร]ยE?Iร{รฏยรฆรYรย<>รฎ3ยฉH=0ยฌยAรยณรย=ยย(ยธรQรรถยยรยนUรกรงรขรพw%D1~Oiรยน)ยพ<รคZยนยบ<รNยดรฒ*ยย}ยต9ยณยAรฌรรUยTaรฑยรดยช'ย5jรถรครด>รรId01	:รยรฒยงjยยบeo?QยHรรจ0Mรขรปr$รยH]รฟยถยป=รรท[[ย(	xยฌfยรรยยชlร<ร)MรงOยฅรรขnยSยกiรยยพ!
รชร#Zยธยกรค ยoยญ\รญsรกef `hoNรยฎQยNpยฟร`	รmรยฟรรฒVรนรรยฏย;รkยครฌยร7
qยต!ยฉรกรยยบzยดยฆร]ยE?Iร{รฏยรฆรYรย<>รฎ3ยฉH=0ยฌยAรยณรย=ยย(ยธรQรรถยยรยนUรกรงรขรพw%D1~Oiรยน)ยพ<รคZยนยบ<UรNยดรฒ*ยย}ยต9ยณยAรฌรรUยTaรฑยรดยช'ย5jรถรครด>รรId01	:รยรฒยงjยยบeo?QยHรรจ0Mรขรปr$รยH]รฟยถยป=รรท[[ย(	xยฌfยรรยยชlร<ร)MรงOยฅรรขnยSยกiรยยพ!
รชร#Zยธยกรค ยoยญ\รญsรกef `hoNรยฎQยNpยฟร`	รmรยฟรรฒVรนรรยฏย;รkยครฌยร7
qยต!ยฉรกรยยบzยดยฆร]ยE?Iร{รฏยรฆรYรย<>รฎ3ยฉH=0ยฌยAรยณรย=ยย(ยธรQรรถยยรยนUรกรงรขรพw%D1~Oiรยน)ยพ<รคZยนยบ<UkรNยดรฒ*ยย}ยต9ยณยAรฌรรUยTaรฑยรดยช'ย5jรถรครด>รรId01	:รยรฒยงjยยบeo?QยHรรจ0Mรขรปr$รยH]รฟยถยป=รรท[[ย(	xยฌfยรรยยชlร<ร)MรงOยฅรรขnยSยกiรยยพ!
รชร#Zยธยกรค ยoยญ\รญsรกef `hoNรยฎQยNpยฟร`	รmรยฟรรฒVรนรรยฏย;รkยครฌยร7
qยต!ยฉรกรยยบzยดยฆร]ยE?Iร{รฏยรฆรYรย<>รฎ3ยฉH=0ยฌยAรยณรย=ยย(ยธรQรรถยยรยนUรกรงรขรพw%D1~Oiรยน)ยพ<รคZยนยบ<UkยรNยดรฒ*ยย}ยต9ยณยAรฌรรUยTaรฑยรดยช'ย5jรถรครด>รรId01	:รยรฒยงjยยบeo?QยHรรจ0Mรขรปr$รยH]รฟยถยป=รรท[[ย(	xยฌfยรรยยชlร<ร)MรงOยฅรรขnยSยกiรยยพ!
รชร#Zยธยกรค ยoยญ\รญsรกef `hoNรยฎQยNpยฟร`	รmรยฟรรฒVรนรรยฏย;รkยครฌยร7
qยต!ยฉรกรยยบzยดยฆร]ยE?Iร{รฏยรฆรYรย<>รฎ3ยฉH=0ยฌยAรยณรย=ยย(ยธรQรรถยยรยนUรกรงรขรพw%D1~Oiรยน)ยพ<รคZยนยบ<UkยยรNยดรฒ*ยย}ยต9ยณยAรฌรรUยTaรฑยรดยช'ย5jรถรครด>รรId01	:รยรฒยงjยยบeo?QยHรรจ0Mรขรปr$รยH]รฟยถยป=รรท[[ย(	xยฌfยรรยยชlร<ร)MรงOยฅรรขnยSยกiรยยพ!
รชร#Zยธยกรค ยoยญ\รญsรกef `hoNรยฎQยNpยฟร`	รmรยฟรรฒVรนรรยฏย;รkยครฌยร7
qยต!ยฉรกรยยบzยดยฆร]ยE?Iร{รฏยรฆรYรย<>รฎ3ยฉH=0ยฌยAรยณรย=ยย(ยธรQรรถยยรยนUรกรงรขรพw%D1~Oiรยน)ยพ<รคZยนยบ<UkยยยรNยดรฒ*ยย}ยต9ยณยAรฌรรUยTaรฑยรดยช'ย5jรถรครด>รรId01	:รยรฒยงjยยบeo?QยHรรจ0Mรขรปr$รยH]รฟยถยป=รรท[[ย(	xยฌfยรรยยชlร<ร)MรงOยฅรรขnยSยกiรยยพ!
รชร#Zยธยกรค ยoยญ\รญsรกef `hoNรยฎQยNpยฟร`	รmรยฟรรฒVรนรรยฏย;รkยครฌยร7
qยต!ยฉรกรยยบzยดยฆร]ยE?Iร{รฏยรฆรYรย<>รฎ3ยฉH=0ยฌยAรยณรย=ยย(ยธรQรรถยยรยนUรกรงรขรพw%D1~Oiรยน)ยพ<รคZยนยบ<Ukยยย~รNยดรฒ*ยย}ยต9ยณยAรฌรรUยTaรฑยรดยช'ย5jรถรครด>รรId01	:รยรฒยงjยยบeo?QยHรรจ0Mรขรปr$รยH]รฟยถยป=รรท[[ย(	xยฌfยรรยยชlร<ร)MรงOยฅรรขnยSยกiรยยพ!
รชร#Zยธยกรค ยoยญ\รญsรกef `hoNรยฎQยNpยฟร`	รmรยฟรรฒVรนรรยฏย;รkยครฌยร7
qยต!ยฉรกรยยบzยดยฆร]ยE?Iร{รฏยรฆรYรย<>รฎ3ยฉH=0ยฌยAรยณรย=ยย(ยธรQรรถยยรยนUรกรงรขรพw%D1~Oiรยน)ยพ<รคZยนยบ<Ukยยย~รรNยดรฒ*ยย}ยต9ยณยAรฌรรUยTaรฑยรดยช'ย5jรถรครด>รรId01	:รยรฒยงjยยบeo?QยHรรจ0Mรขรปr$รยH]รฟยถยป=รรท[[ย(	xยฌfยรรยยชlร<ร)MรงOยฅรรขnยSยกiรยยพ!
รชร#Zยธยกรค ยoยญ\รญsรกef `hoNรยฎQยNpยฟร`	รmรยฟรรฒVรนรรยฏย;รkยครฌยร7
qยต!ยฉรกรยยบzยดยฆร]ยE?Iร{รฏยรฆรYรย<>รฎ3ยฉH=0ยฌยAรยณรย=ยย(ยธรQรรถยยรยนUรกรงรขรพw%D1~Oiรยน)ยพ<รคZยนยบ<Ukยยย~รยรNยดรฒ*ยย}ยต9ยณยAรฌรรUยTaรฑยรดยช'ย5jรถรครด>รรId01	:รยรฒยงjยยบeo?QยHรรจ0Mรขรปr$รยH]รฟยถยป=รรท[[ย(	xยฌfยรรยยชlร<ร)MรงOยฅรรขnยSยกiรยยพ!
รชร#Zยธยกรค ยoยญ\รญsรกef `hoNรยฎQยNpยฟร`	รmรยฟรรฒVรนรรยฏย;รkยครฌยร7
qยต!ยฉรกรยยบzยดยฆร]ยE?Iร{รฏยรฆรYรย<>รฎ3ยฉH=0ยฌยAรยณรย=ยย(ยธรQรรถยยรยนUรกรงรขรพw%D1~Oiรยน)ยพ<รคZยนยบ<Ukยยย~รย^รNยดรฒ*ยย}ยต9ยณยAรฌรรUยTaรฑยรดยช'ย5jรถรครด>รรId01	:รยรฒยงjยยบeo?QยHรรจ0Mรขรปr$รยH]รฟยถยป=รรท[[ย(	xยฌfยรรยยชlร<ร)MรงOยฅรรขnยSยกiรยยพ!
รชร#Zยธยกรค ยoยญ\รญsรกef `hoNรยฎQยNpยฟร`	รmรยฟรรฒVรนรรยฏย;รkยครฌยร7
qยต!ยฉรกรยยบzยดยฆร]ยE?Iร{รฏยรฆรYรย<>รฎ3ยฉH=0ยฌยAรยณรย=ยย(ยธรQรรถยยรยนUรกรงรขรพw%D1~Oiรยน)ยพ<รคZยนยบ<Ukยยย~รย^รผรNยดรฒ*ยย}ยต9ยณยAรฌรรUยTaรฑยรดยช'ย5jรถรครด>รรId01	:รยรฒยงjยยบeo?QยHรรจ0Mรขรปr$รยH]รฟยถยป=รรท[[ย(	xยฌfยรรยยชlร<ร)MรงOยฅรรขnยSยกiรยยพ!
รชร#Zยธยกรค ยoยญ\รญsรกef `hoNรยฎQยNpยฟร`	รmรยฟรรฒVรนรรยฏย;รkยครฌยร7
qยต!ยฉรกรยยบzยดยฆร]ยE?Iร{รฏยรฆรYรย<>รฎ3ยฉH=0ยฌยAรยณรย=ยย(ยธรQรรถยยรยนUรกรงรขรพw%D1~Oiรยน)ยพ<รคZยนยบ<Ukยยย~รย^รผ<รNยดรฒ*ยย}ยต9ยณยAรฌรรUยTaรฑยรดยช'ย5jรถรครด>รรId01	:รยรฒยงjยยบeo?QยHรรจ0Mรขรปr$รยH]รฟยถยป=รรท[[ย(	xยฌfยรรยยชlร<ร)MรงOยฅรรขnยSยกiรยยพ!
รชร#Zยธยกรค ยoยญ\รญsรกef `hoNรยฎQยNpยฟร`	รmรยฟรรฒVรนรรยฏย;รkยครฌยร7
qยต!ยฉรกรยยบzยดยฆร]ยE?Iร{รฏยรฆรYรย<>รฎ3ยฉH=0ยฌยAรยณรย=ยย(ยธรQรรถยยรยนUรกรงรขรพw%D1~Oiรยน)ยพ<รคZยนยบ<Ukยยย~รย^รผ<รNยดรฒ*ยย}ยต9ยณยAรฌรรUยTaรฑยรดยช'ย5jรถรครด>รรId01	:รยรฒยงjยยบeo?QยHรรจ0Mรขรปr$รยH]รฟยถยป=รรท[[ย(	xยฌfยรรยยชlร<ร)MรงOยฅรรขnยSยกiรยยพ!
รชร#Zยธยกรค ยoยญ\รญsรกef `hoNรยฎQยNpยฟร`	รmรยฟรรฒVรนรรยฏย;รkยครฌยร7
qยต!ยฉรกรยยบzยดยฆร]ยE?Iร{รฏยรฆรYรย<>รฎ3ยฉH=0ยฌยAรยณรย=ยย(ยธรQรรถยยรยนUรกรงรขรพw%D1~Oiรยน)ยพ<รคZยนยบ<Ukยยย~รย^รผ<ยรNยดรฒ*ยย}ยต9ยณยAรฌรรUยTaรฑยรดยช'ย5jรถรครด>รรId01	:รยรฒยงjยยบeo?QยHรรจ0Mรขรปr$รยH]รฟยถยป=รรท[[ย(	xยฌfยรรยยชlร<ร)MรงOยฅรรขnยSยกiรยยพ!
รชร#Zยธยกรค ยoยญ\รญsรกef `hoNรยฎQยNpยฟร`	รmรยฟรรฒVรนรรยฏย;รkยครฌยร7
qยต!ยฉรกรยยบzยดยฆร]ยE?Iร{รฏยรฆรYรย<>รฎ3ยฉH=0ยฌยAรยณรย=ยย(ยธรQรรถยยรยนUรกรงรขรพw%D1~Oiรยน)ยพ<รคZยนยบ<Ukยยย~รย^รผ<ยรฟรNยดรฒ*ยย}ยต9ยณยAรฌรรUยTaรฑยรดยช'ย5jรถรครด>รรId01	:รยรฒยงjยยบeo?QยHรรจ0Mรขรปr$รยH]รฟยถยป=รรท[[ย(	xยฌfยรรยยชlร<ร)MรงOยฅรรขnยSยกiรยยพ!
รชร#Zยธยกรค ยoยญ\รญsรกef `hoNรยฎQยNpยฟร`	รmรยฟรรฒVรนรรยฏย;รkยครฌยร7
qยต!ยฉรกรยยบzยดยฆร]ยE?Iร{รฏยรฆรYรย<>รฎ3ยฉH=0ยฌยAรยณรย=ยย(ยธรQรรถยยรยนUรกรงรขรพw%D1~Oiรยน)ยพ<รคZยนยบ<Ukยยย~รย^รผ<ยรฟ-รNยดรฒ*ยย}ยต9ยณยAรฌรรUยTaรฑยรดยช'ย5jรถรครด>รรId01	:รยรฒยงjยยบeo?QยHรรจ0Mรขรปr$รยH]รฟยถยป=รรท[[ย(	xยฌfยรรยยชlร<ร)MรงOยฅรรขnยSยกiรยยพ!
รชร#Zยธยกรค ยoยญ\รญsรกef `hoNรยฎQยNpยฟร`	รmรยฟรรฒVรนรรยฏย;รkยครฌยร7
qยต!ยฉรกรยยบzยดยฆร]ยE?Iร{รฏยรฆรYรย<>รฎ3ยฉH=0ยฌยAรยณรย=ยย(ยธรQรรถยยรยนUรกรงรขรพw%D1~Oiรยน)ยพ<รคZยนยบ<Ukยยย~รย^รผ<ยรฟ-รชรNยดรฒ*ยย}ยต9ยณยAรฌรรUยTaรฑยรดยช'ย5jรถรครด>รรId01	:รยรฒยงjยยบeo?QยHรรจ0Mรขรปr$รยH]รฟยถยป=รรท[[ย(	xยฌfยรรยยชlร<ร)MรงOยฅรรขnยSยกiรยยพ!
รชร#Zยธยกรค ยoยญ\รญsรกef `hoNรยฎQยNpยฟร`	รmรยฟรรฒVรนรรยฏย;รkยครฌยร7
qยต!ยฉรกรยยบzยดยฆร]ยE?Iร{รฏยรฆรYรย<>รฎ3ยฉH=0ยฌยAรยณรย=ยย(ยธรQรรถยยรยนUรกรงรขรพw%D1~Oiรยน)ยพ<รคZยนยบ<Ukยยย~รย^รผ<ยรฟ-รชรNยดรฒ*ยย}ยต9ยณยAรฌรรUยTaรฑยรดยช'ย5jรถรครด>รรId01	:รยรฒยงjยยบeo?QยHรรจ0Mรขรปr$รยH]รฟยถยป=รรท[[ย(	xยฌfยรรยยชlร<ร)MรงOยฅรรขnยSยกiรยยพ!
รชร#Zยธยกรค ยoยญ\รญsรกef `hoNรยฎQยNpยฟร`	รmรยฟรรฒVรนรรยฏย;รkยครฌยร7
qยต!ยฉรกรยยบzยดยฆร]ยE?Iร{รฏยรฆรYรย<>รฎ3ยฉH=0ยฌยAรยณรย=ยย(ยธรQรรถยยรยนUรกรงรขรพw%D1~Oiรยน)ยพ<รคZยนยบ<Ukยยย~รย^รผ<ยรฟ-รชBรNยดรฒ*ยย}ยต9ยณยAรฌรรUยTaรฑยรดยช'ย5jรถรครด>รรId01	:รยรฒยงjยยบeo?QยHรรจ0Mรขรปr$รยH]รฟยถยป=รรท[[ย(	xยฌfยรรยยชlร<ร)MรงOยฅรรขnยSยกiรยยพ!
รชร#Zยธยกรค ยoยญ\รญsรกef `hoNรยฎQยNpยฟร`	รmรยฟรรฒVรนรรยฏย;รkยครฌยร7
qยต!ยฉรกรยยบzยดยฆร]ยE?Iร{รฏยรฆรYรย<>รฎ3ยฉH=0ยฌยAรยณรย=ยย(ยธรQรรถยยรยนUรกรงรขรพw%D1~Oiรยน)ยพ<รคZยนยบ<Ukยยย~รย^รผ<ยรฟ-รชBwรNยดรฒ*ยย}ยต9ยณยAรฌรรUยTaรฑยรดยช'ย5jรถรครด>รรId01	:รยรฒยงjยยบeo?QยHรรจ0Mรขรปr$รยH]รฟยถยป=รรท[[ย(	xยฌfยรรยยชlร<ร)MรงOยฅรรขnยSยกiรยยพ!
รชร#Zยธยกรค ยoยญ\รญsรกef `hoNรยฎQยNpยฟร`	รmรยฟรรฒVรนรรยฏย;รkยครฌยร7
qยต!ยฉรกรยยบzยดยฆร]ยE?Iร{รฏยรฆรYรย<>รฎ3ยฉH=0ยฌยAรยณรย=ยย(ยธรQรรถยยรยนUรกรงรขรพw%D1~Oiรยน)ยพ<รคZยนยบ<Ukยยย~รย^รผ<ยรฟ-รชBwNรNยดรฒ*ยย}ยต9ยณยAรฌรรUยTaรฑยรดยช'ย5jรถรครด>รรId01	:รยรฒยงjยยบeo?QยHรรจ0Mรขรปr$รยH]รฟยถยป=รรท[[ย(	xยฌfยรรยยชlร<ร)MรงOยฅรรขnยSยกiรยยพ!
รชร#Zยธยกรค ยoยญ\รญsรกef `hoNรยฎQยNpยฟร`	รmรยฟรรฒVรนรรยฏย;รkยครฌยร7
qยต!ยฉรกรยยบzยดยฆร]ยE?Iร{รฏยรฆรYรย<>รฎ3ยฉH=0ยฌยAรยณรย=ยย(ยธรQรรถยยรยนUรกรงรขรพw%D1~Oiรยน)ยพ<รคZยนยบ<Ukยยย~รย^รผ<ยรฟ-รชBwNuรNยดรฒ*ยย}ยต9ยณยAรฌรรUยTaรฑยรดยช'ย5jรถรครด>รรId01	:รยรฒยงjยยบeo?QยHรรจ0Mรขรปr$รยH]รฟยถยป=รรท[[ย(	xยฌfยรรยยชlร<ร)MรงOยฅรรขnยSยกiรยยพ!
รชร#Zยธยกรค ยoยญ\รญsรกef `hoNรยฎQยNpยฟร`	รmรยฟรรฒVรนรรยฏย;รkยครฌยร7
qยต!ยฉรกรยยบzยดยฆร]ยE?Iร{รฏยรฆรYรย<>รฎ3ยฉH=0ยฌยAรยณรย=ยย(ยธรQรรถยยรยนUรกรงรขรพw%D1~Oiรยน)ยพ<รคZยนยบ<Ukยยย~รย^รผ<ยรฟ-รชBwNuยผรNยดรฒ*ยย}ยต9ยณยAรฌรรUยTaรฑยรดยช'ย5jรถรครด>รรId01	:รยรฒยงjยยบeo?QยHรรจ0Mรขรปr$รยH]รฟยถยป=รรท[[ย(	xยฌfยรรยยชlร<ร)MรงOยฅรรขnยSยกiรยยพ!
รชร#Zยธยกรค ยoยญ\รญsรกef `hoNรยฎQยNpยฟร`	รmรยฟรรฒVรนรรยฏย;รkยครฌยร7
qยต!ยฉรกรยยบzยดยฆร]ยE?Iร{รฏยรฆรYรย<>รฎ3ยฉH=0ยฌยAรยณรย=ยย(ยธรQรรถยยรยนUรกรงรขรพw%D1~Oiรยน)ยพ<รคZยนยบ<Ukยยย~รย^รผ<ยรฟ-รชBwNuยผรNยดรฒ*ยย}ยต9ยณยAรฌรรUยTaรฑยรดยช'ย5jรถรครด>รรId01	:รยรฒยงjยยบeo?QยHรรจ0Mรขรปr$รยH]รฟยถยป=รรท[[ย(	xยฌfยรรยยชlร<ร)MรงOยฅรรขnยSยกiรยยพ!
รชร#Zยธยกรค ยoยญ\รญsรกef `hoNรยฎQยNpยฟร`	รmรยฟรรฒVรนรรยฏย;รkยครฌยร7
qยต!ยฉรกรยยบzยดยฆร]ยE?Iร{รฏยรฆรYรย<>รฎ3ยฉH=0ยฌยAรยณรย=ยย(ยธรQรรถยยรยนUรกรงรขรพw%D1~Oiรยน)ยพ<รคZยนยบ<Ukยยย~รย^รผ<ยรฟ-รชBwNuยผรNยดรฒ*ยย}ยต9ยณยAรฌรรUยTaรฑยรดยช'ย5jรถรครด>รรId01	:รยรฒยงjยยบeo?QยHรรจ0Mรขรปr$รยH]รฟยถยป=รรท[[ย(	xยฌfยรรยยชlร<ร)MรงOยฅรรขnยSยกiรยยพ!
รชร#Zยธยกรค ยoยญ\รญsรกef `hoNรยฎQยNpยฟร`	รmรยฟรรฒVรนรรยฏย;รkยครฌยร7
qยต!ยฉรกรยยบzยดยฆร]ยE?Iร{รฏยรฆรYรย<>รฎ3ยฉH=0ยฌยAรยณรย=ยย(ยธรQรรถยยรยนUรกรงรขรพw%D1~Oiรยน)ยพ<รคZยนยบ<Ukยยย~รย^รผ<ยรฟ-รชBwNuยผรรNยดรฒ*ยย}ยต9ยณยAรฌรรUยTaรฑยรดยช'ย5jรถรครด>รรId01	:รยรฒยงjยยบeo?QยHรรจ0Mรขรปr$รยH]รฟยถยป=รรท[[ย(	xยฌfยรรยยชlร<ร)MรงOยฅรรขnยSยกiรยยพ!
รชร#Zยธยกรค ยoยญ\รญsรกef `hoNรยฎQยNpยฟร`	รmรยฟรรฒVรนรรยฏย;รkยครฌยร7
qยต!ยฉรกรยยบzยดยฆร]ยE?Iร{รฏยรฆรYรย<>รฎ3ยฉH=0ยฌยAรยณรย=ยย(ยธรQรรถยยรยนUรกรงรขรพw%D1~Oiรยน)ยพ<รคZยนยบ<Ukยยย~รย^รผ<ยรฟ-รชBwNuยผรZรNยดรฒ*ยย}ยต9ยณยAรฌรรUยTaรฑยรดยช'ย5jรถรครด>รรId01	:รยรฒยงjยยบeo?QยHรรจ0Mรขรปr$รยH]รฟยถยป=รรท[[ย(	xยฌfยรรยยชlร<ร)MรงOยฅรรขnยSยกiรยยพ!
รชร#Zยธยกรค ยoยญ\รญsรกef `hoNรยฎQยNpยฟร`	รmรยฟรรฒVรนรรยฏย;รkยครฌยร7
qยต!ยฉรกรยยบzยดยฆร]ยE?Iร{รฏยรฆรYรย<>รฎ3ยฉH=0ยฌยAรยณรย=ยย(ยธรQรรถยยรยนUรกรงรขรพw%D1~Oiรยน)ยพ<รคZยนยบ<Ukยยย~รย^รผ<ยรฟ-รชBwNuยผรZยฟรNยดรฒ*ยย}ยต9ยณยAรฌรรUยTaรฑยรดยช'ย5jรถรครด>รรId01	:รยรฒยงjยยบeo?QยHรรจ0Mรขรปr$รยH]รฟยถยป=รรท[[ย(	xยฌfยรรยยชlร<ร)MรงOยฅรรขnยSยกiรยยพ!
รชร#Zยธยกรค ยoยญ\รญsรกef `hoNรยฎQยNpยฟร`	รmรยฟรรฒVรนรรยฏย;รkยครฌยร7
qยต!ยฉรกรยยบzยดยฆร]ยE?Iร{รฏยรฆรYรย<>รฎ3ยฉH=0ยฌยAรยณรย=ยย(ยธรQรรถยยรยนUรกรงรขรพw%D1~Oiรยน)ยพ<รคZยนยบ<Ukยยย~รย^รผ<ยรฟ-รชBwNuยผรZยฟ1รNยดรฒ*ยย}ยต9ยณยAรฌรรUยTaรฑยรดยช'ย5jรถรครด>รรId01	:รยรฒยงjยยบeo?QยHรรจ0Mรขรปr$รยH]รฟยถยป=รรท[[ย(	xยฌfยรรยยชlร<ร)MรงOยฅรรขnยSยกiรยยพ!
รชร#Zยธยกรค ยoยญ\รญsรกef `hoNรยฎQยNpยฟร`	รmรยฟรรฒVรนรรยฏย;รkยครฌยร7
qยต!ยฉรกรยยบzยดยฆร]ยE?Iร{รฏยรฆรYรย<>รฎ3ยฉH=0ยฌยAรยณรย=ยย(ยธรQรรถยยรยนUรกรงรขรพw%D1~Oiรยน)ยพ<รคZยนยบ<Ukยยย~รย^รผ<ยรฟ-รชBwNuยผรZยฟ1ยบรNยดรฒ*ยย}ยต9ยณยAรฌรรUยTaรฑยรดยช'ย5jรถรครด>รรId01	:รยรฒยงjยยบeo?QยHรรจ0Mรขรปr$รยH]รฟยถยป=รรท[[ย(	xยฌfยรรยยชlร<ร)MรงOยฅรรขnยSยกiรยยพ!
รชร#Zยธยกรค ยoยญ\รญsรกef `hoNรยฎQยNpยฟร`	รmรยฟรรฒVรนรรยฏย;รkยครฌยร7
qยต!ยฉรกรยยบzยดยฆร]ยE?Iร{รฏยรฆรYรย<>รฎ3ยฉH=0ยฌยAรยณรย=ยย(ยธรQรรถยยรยนUรกรงรขรพw%D1~Oiรยน)ยพ<รคZยนยบ<Ukยยย~รย^รผ<ยรฟ-รชBwNuยผรZยฟ1ยบaรNยดรฒ*ยย}ยต9ยณยAรฌรรUยTaรฑยรดยช'ย5jรถรครด>รรId01	:รยรฒยงjยยบeo?QยHรรจ0Mรขรปr$รยH]รฟยถยป=รรท[[ย(	xยฌfยรรยยชlร<ร)MรงOยฅรรขnยSยกiรยยพ!
รชร#Zยธยกรค ยoยญ\รญsรกef `hoNรยฎQยNpยฟร`	รmรยฟรรฒVรนรรยฏย;รkยครฌยร7
qยต!ยฉรกรยยบzยดยฆร]ยE?Iร{รฏยรฆรYรย<>รฎ3ยฉH=0ยฌยAรยณรย=ยย(ยธรQรรถยยรยนUรกรงรขรพw%D1~Oiรยน)ยพ<รคZยนยบ<Ukยยย~รย^รผ<ยรฟ-รชBwNuยผรZยฟ1ยบaรรNยดรฒ*ยย}ยต9ยณยAรฌรรUยTaรฑยรดยช'ย5jรถรครด>รรId01	:รยรฒยงjยยบeo?QยHรรจ0Mรขรปr$รยH]รฟยถยป=รรท[[ย(	xยฌfยรรยยชlร<ร)MรงOยฅรรขnยSยกiรยยพ!
รชร#Zยธยกรค ยoยญ\รญsรกef `hoNรยฎQยNpยฟร`	รmรยฟรรฒVรนรรยฏย;รkยครฌยร7
qยต!ยฉรกรยยบzยดยฆร]ยE?Iร{รฏยรฆรYรย<>รฎ3ยฉH=0ยฌยAรยณรย=ยย(ยธรQรรถยยรยนUรกรงรขรพw%D1~Oiรยน)ยพ<รคZยนยบ<Ukยยย~รย^รผ<ยรฟ-รชBwNuยผรZยฟ1ยบaร%รNยดรฒ*ยย}ยต9ยณยAรฌรรUยTaรฑยรดยช'ย5jรถรครด>รรId01	:รยรฒยงjยยบeo?QยHรรจ0Mรขรปr$รยH]รฟยถยป=รรท[[ย(	xยฌfยรรยยชlร<ร)MรงOยฅรรขnยSยกiรยยพ!
รชร#Zยธยกรค ยoยญ\รญsรกef `hoNรยฎQยNpยฟร`	รmรยฟรรฒVรนรรยฏย;รkยครฌยร7
qยต!ยฉรกรยยบzยดยฆร]ยE?Iร{รฏยรฆรYรย<>รฎ3ยฉH=0ยฌยAรยณรย=ยย(ยธรQรรถยยรยนUรกรงรขรพw%D1~Oiรยน)ยพ<รคZยนยบ<Ukยยย~รย^รผ<ยรฟ-รชBwNuยผรZยฟ1ยบaร%รฌรNยดรฒ*ยย}ยต9ยณยAรฌรรUยTaรฑยรดยช'ย5jรถรครด>รรId01	:รยรฒยงjยยบeo?QยHรรจ0Mรขรปr$รยH]รฟยถยป=รรท[[ย(	xยฌfยรรยยชlร<ร)MรงOยฅรรขnยSยกiรยยพ!
รชร#Zยธยกรค ยoยญ\รญsรกef `hoNรยฎQยNpยฟร`	รmรยฟรรฒVรนรรยฏย;รkยครฌยร7
qยต!ยฉรกรยยบzยดยฆร]ยE?Iร{รฏยรฆรYรย<>รฎ3ยฉH=0ยฌยAรยณรย=ยย(ยธรQรรถยยรยนUรกรงรขรพw%D1~Oiรยน)ยพ<รคZยนยบ<Ukยยย~รย^รผ<ยรฟ-รชBwNuยผรZยฟ1ยบaร%รฌyรNยดรฒ*ยย}ยต9ยณยAรฌรรUยTaรฑยรดยช'ย5jรถรครด>รรId01	:รยรฒยงjยยบeo?QยHรรจ0Mรขรปr$รยH]รฟยถยป=รรท[[ย(	xยฌfยรรยยชlร<ร)MรงOยฅรรขnยSยกiรยยพ!
รชร#Zยธยกรค ยoยญ\รญsรกef `hoNรยฎQยNpยฟร`	รmรยฟรรฒVรนรรยฏย;รkยครฌยร7
qยต!ยฉรกรยยบzยดยฆร]ยE?Iร{รฏยรฆรYรย<>รฎ3ยฉH=0ยฌยAรยณรย=ยย(ยธรQรรถยยรยนUรกรงรขรพw%D1~Oiรยน)ยพ<รคZยนยบ<Ukยยย~รย^รผ<ยรฟ-รชBwNuยผรZยฟ1ยบaร%รฌyMรNยดรฒ*ยย}ยต9ยณยAรฌรรUยTaรฑยรดยช'ย5jรถรครด>รรId01	:รยรฒยงjยยบeo?QยHรรจ0Mรขรปr$รยH]รฟยถยป=รรท[[ย(	xยฌfยรรยยชlร<ร)MรงOยฅรรขnยSยกiรยยพ!
รชร#Zยธยกรค ยoยญ\รญsรกef `hoNรยฎQยNpยฟร`	รmรยฟรรฒVรนรรยฏย;รkยครฌยร7
qยต!ยฉรกรยยบzยดยฆร]ยE?Iร{รฏยรฆรYรย<>รฎ3ยฉH=0ยฌยAรยณรย=ยย(ยธรQรรถยยรยนUรกรงรขรพw%D1~Oiรยน)ยพ<รคZยนยบ<Ukยยย~รย^รผ<ยรฟ-รชBwNuยผรZยฟ1ยบaร%รฌyMยรNยดรฒ*ยย}ยต9ยณยAรฌรรUยTaรฑยรดยช'ย5jรถรครด>รรId01	:รยรฒยงjยยบeo?QยHรรจ0Mรขรปr$รยH]รฟยถยป=รรท[[ย(	xยฌfยรรยยชlร<ร)MรงOยฅรรขnยSยกiรยยพ!
รชร#Zยธยกรค ยoยญ\รญsรกef `hoNรยฎQยNpยฟร`	รmรยฟรรฒVรนรรยฏย;รkยครฌยร7
qยต!ยฉรกรยยบzยดยฆร]ยE?Iร{รฏยรฆรYรย<>รฎ3ยฉH=0ยฌยAรยณรย=ยย(ยธรQรรถยยรยนUรกรงรขรพw%D1~Oiรยน)ยพ<รคZยนยบ<Ukยยย~รย^รผ<ยรฟ-รชBwNuยผรZยฟ1ยบaร%รฌyMยรรNยดรฒ*ยย}ยต9ยณยAรฌรรUยTaรฑยรดยช'ย5jรถรครด>รรId01	:รยรฒยงjยยบeo?QยHรรจ0Mรขรปr$รยH]รฟยถยป=รรท[[ย(	xยฌfยรรยยชlร<ร)MรงOยฅรรขnยSยกiรยยพ!
รชร#Zยธยกรค ยoยญ\รญsรกef `hoNรยฎQยNpยฟร`	รmรยฟรรฒVรนรรยฏย;รkยครฌยร7
qยต!ยฉรกรยยบzยดยฆร]ยE?Iร{รฏยรฆรYรย<>รฎ3ยฉH=0ยฌยAรยณรย=ยย(ยธรQรรถยยรยนUรกรงรขรพw%D1~Oiรยน)ยพ<รคZยนยบ<Ukยยย~รย^รผ<ยรฟ-รชBwNuยผรZยฟ1ยบaร%รฌyMยร0รNยดรฒ*ยย}ยต9ยณยAรฌรรUยTaรฑยรดยช'ย5jรถรครด>รรId01	:รยรฒยงjยยบeo?QยHรรจ0Mรขรปr$รยH]รฟยถยป=รรท[[ย(	xยฌfยรรยยชlร<ร)MรงOยฅรรขnยSยกiรยยพ!
รชร#Zยธยกรค ยoยญ\รญsรกef `hoNรยฎQยNpยฟร`	รmรยฟรรฒVรนรรยฏย;รkยครฌยร7
qยต!ยฉรกรยยบzยดยฆร]ยE?Iร{รฏยรฆรYรย<>รฎ3ยฉH=0ยฌยAรยณรย=ยย(ยธรQรรถยยรยนUรกรงรขรพw%D1~Oiรยน)ยพ<รคZยนยบ<Ukยยย~รย^รผ<ยรฟ-รชBwNuยผรZยฟ1ยบaร%รฌyMยร0รตรNยดรฒ*ยย}ยต9ยณยAรฌรรUยTaรฑยรดยช'ย5jรถรครด>รรId01	:รยรฒยงjยยบeo?QยHรรจ0Mรขรปr$รยH]รฟยถยป=รรท[[ย(	xยฌfยรรยยชlร<ร)MรงOยฅรรขnยSยกiรยยพ!
รชร#Zยธยกรค ยoยญ\รญsรกef `hoNรยฎQยNpยฟร`	รmรยฟรรฒVรนรรยฏย;รkยครฌยร7
qยต!ยฉรกรยยบzยดยฆร]ยE?Iร{รฏยรฆรYรย<>รฎ3ยฉH=0ยฌยAรยณรย=ยย(ยธรQรรถยยรยนUรกรงรขรพw%D1~Oiรยน)ยพ<รคZยนยบ<Ukยยย~รย^รผ<ยรฟ-รชBwNuยผรZยฟ1ยบaร%รฌyMยร0รต{รNยดรฒ*ยย}ยต9ยณยAรฌรรUยTaรฑยรดยช'ย5jรถรครด>รรId01	:รยรฒยงjยยบeo?QยHรรจ0Mรขรปr$รยH]รฟยถยป=รรท[[ย(	xยฌfยรรยยชlร<ร)MรงOยฅรรขnยSยกiรยยพ!
รชร#Zยธยกรค ยoยญ\รญsรกef `hoNรยฎQยNpยฟร`	รmรยฟรรฒVรนรรยฏย;รkยครฌยร7
qยต!ยฉรกรยยบzยดยฆร]ยE?Iร{รฏยรฆรYรย<>รฎ3ยฉH=0ยฌยAรยณรย=ยย(ยธรQรรถยยรยนUรกรงรขรพw%D1~Oiรยน)ยพ<รคZยนยบ<Ukยยย~รย^รผ<ยรฟ-รชBwNuยผรZยฟ1ยบaร%รฌyMยร0รต{ยรNยดรฒ*ยย}ยต9ยณยAรฌรรUยTaรฑยรดยช'ย5jรถรครด>รรId01	:รยรฒยงjยยบeo?QยHรรจ0Mรขรปr$รยH]รฟยถยป=รรท[[ย(	xยฌfยรรยยชlร<ร)MรงOยฅรรขnยSยกiรยยพ!
รชร#Zยธยกรค ยoยญ\รญsรกef `hoNรยฎQยNpยฟร`	รmรยฟรรฒVรนรรยฏย;รkยครฌยร7
qยต!ยฉรกรยยบzยดยฆร]ยE?Iร{รฏยรฆรYรย<>รฎ3ยฉH=0ยฌยAรยณรย=ยย(ยธรQรรถยยรยนUรกรงรขรพw%D1~Oiรยน)ยพ<รคZยนยบ<Ukยยย~รย^รผ<ยรฟ-รชBwNuยผรZยฟ1ยบaร%รฌyMยร0รต{ยรNยดรฒ*ยย}ยต9ยณยAรฌรรUยTaรฑยรดยช'ย5jรถรครด>รรId01	:รยรฒยงjยยบeo?QยHรรจ0Mรขรปr$รยH]รฟยถยป=รรท[[ย(	xยฌfยรรยยชlร<ร)MรงOยฅรรขnยSยกiรยยพ!
รชร#Zยธยกรค ยoยญ\รญsรกef `hoNรยฎQยNpยฟร`	รmรยฟรรฒVรนรรยฏย;รkยครฌยร7
qยต!ยฉรกรยยบzยดยฆร]ยE?Iร{รฏยรฆรYรย<>รฎ3ยฉH=0ยฌยAรยณรย=ยย(ยธรQรรถยยรยนUรกรงรขรพw%D1~Oiรยน)ยพ<รคZยนยบ<Ukยยย~รย^รผ<ยรฟ-รชBwNuยผรZยฟ1ยบaร%รฌyMยร0รต{ยรฏรNยดรฒ*ยย}ยต9ยณยAรฌรรUยTaรฑยรดยช'ย5jรถรครด>รรId01	:รยรฒยงjยยบeo?QยHรรจ0Mรขรปr$รยH]รฟยถยป=รรท[[ย(	xยฌfยรรยยชlร<ร)MรงOยฅรรขnยSยกiรยยพ!
รชร#Zยธยกรค ยoยญ\รญsรกef `hoNรยฎQยNpยฟร`	รmรยฟรรฒVรนรรยฏย;รkยครฌยร7
qยต!ยฉรกรยยบzยดยฆร]ยE?Iร{รฏยรฆรYรย<>รฎ3ยฉH=0ยฌยAรยณรย=ยย(ยธรQรรถยยรยนUรกรงรขรพw%D1~Oiรยน)ยพ<รคZยนยบ<Ukยยย~รย^รผ<ยรฟ-รชBwNuยผรZยฟ1ยบaร%รฌyMยร0รต{ยรฏ.รNยดรฒ*ยย}ยต9ยณยAรฌรรUยTaรฑยรดยช'ย5jรถรครด>รรId01	:รยรฒยงjยยบeo?QยHรรจ0Mรขรปr$รยH]รฟยถยป=รรท[[ย(	xยฌfยรรยยชlร<ร)MรงOยฅรรขnยSยกiรยยพ!
รชร#Zยธยกรค ยoยญ\รญsรกef `hoNรยฎQยNpยฟร`	รmรยฟรรฒVรนรรยฏย;รkยครฌยร7
qยต!ยฉรกรยยบzยดยฆร]ยE?Iร{รฏยรฆรYรย<>รฎ3ยฉH=0ยฌยAรยณรย=ยย(ยธรQรรถยยรยนUรกรงรขรพw%D1~Oiรยน)ยพ<รคZยนยบ<Ukยยย~รย^รผ<ยรฟ-รชBwNuยผรZยฟ1ยบaร%รฌyMยร0รต{ยรฏ.AรNยดรฒ*ยย}ยต9ยณยAรฌรรUยTaรฑยรดยช'ย5jรถรครด>รรId01	:รยรฒยงjยยบeo?QยHรรจ0Mรขรปr$รยH]รฟยถยป=รรท[[ย(	xยฌfยรรยยชlร<ร)MรงOยฅรรขnยSยกiรยยพ!
รชร#Zยธยกรค ยoยญ\รญsรกef `hoNรยฎQยNpยฟร`	รmรยฟรรฒVรนรรยฏย;รkยครฌยร7
qยต!ยฉรกรยยบzยดยฆร]ยE?Iร{รฏยรฆรYรย<>รฎ3ยฉH=0ยฌยAรยณรย=ยย(ยธรQรรถยยรยนUรกรงรขรพw%D1~Oiรยน)ยพ<รคZยนยบ<Ukยยย~รย^รผ<ยรฟ-รชBwNuยผรZยฟ1ยบaร%รฌyMยร0รต{ยรฏ.ApรNยดรฒ*ยย}ยต9ยณยAรฌรรUยTaรฑยรดยช'ย5jรถรครด>รรId01	:รยรฒยงjยยบeo?QยHรรจ0Mรขรปr$รยH]รฟยถยป=รรท[[ย(	xยฌfยรรยยชlร<ร)MรงOยฅรรขnยSยกiรยยพ!
รชร#Zยธยกรค ยoยญ\รญsรกef `hoNรยฎQยNpยฟร`	รmรยฟรรฒVรนรรยฏย;รkยครฌยร7
qยต!ยฉรกรยยบzยดยฆร]ยE?Iร{รฏยรฆรYรย<>รฎ3ยฉH=0ยฌยAรยณรย=ยย(ยธรQรรถยยรยนUรกรงรขรพw%D1~Oiรยน)ยพ<รคZยนยบ<Ukยยย~รย^รผ<ยรฟ-รชBwNuยผรZยฟ1ยบaร%รฌyMยร0รต{ยรฏ.ApcรNยดรฒ*ยย}ยต9ยณยAรฌรรUยTaรฑยรดยช'ย5jรถรครด>รรId01	:รยรฒยงjยยบeo?QยHรรจ0Mรขรปr$รยH]รฟยถยป=รรท[[ย(	xยฌfยรรยยชlร<ร)MรงOยฅรรขnยSยกiรยยพ!
รชร#Zยธยกรค ยoยญ\รญsรกef `hoNรยฎQยNpยฟร`	รmรยฟรรฒVรนรรยฏย;รkยครฌยร7
qยต!ยฉรกรยยบzยดยฆร]ยE?Iร{รฏยรฆรYรย<>รฎ3ยฉH=0ยฌยAรยณรย=ยย(ยธรQรรถยยรยนUรกรงรขรพw%D1~Oiรยน)ยพ<รคZยนยบ<Ukยยย~รย^รผ<ยรฟ-รชBwNuยผรZยฟ1ยบaร%รฌyMยร0รต{ยรฏ.ApcยนรNยดรฒ*ยย}ยต9ยณยAรฌรรUยTaรฑยรดยช'ย5jรถรครด>รรId01	:รยรฒยงjยยบeo?QยHรรจ0Mรขรปr$รยH]รฟยถยป=รรท[[ย(	xยฌfยรรยยชlร<ร)MรงOยฅรรขnยSยกiรยยพ!
รชร#Zยธยกรค ยoยญ\รญsรกef `hoNรยฎQยNpยฟร`	รmรยฟรรฒVรนรรยฏย;รkยครฌยร7
qยต!ยฉรกรยยบzยดยฆร]ยE?Iร{รฏยรฆรYรย<>รฎ3ยฉH=0ยฌยAรยณรย=ยย(ยธรQรรถยยรยนUรกรงรขรพw%D1~Oiรยน)ยพ<รคZยนยบ<Ukยยย~รย^รผ<ยรฟ-รชBwNuยผรZยฟ1ยบaร%รฌyMยร0รต{ยรฏ.ApcยนยฝรNยดรฒ*ยย}ยต9ยณยAรฌรรUยTaรฑยรดยช'ย5jรถรครด>รรId01	:รยรฒยงjยยบeo?QยHรรจ0Mรขรปr$รยH]รฟยถยป=รรท[[ย(	xยฌfยรรยยชlร<ร)MรงOยฅรรขnยSยกiรยยพ!
รชร#Zยธยกรค ยoยญ\รญsรกef `hoNรยฎQยNpยฟร`	รmรยฟรรฒVรนรรยฏย;รkยครฌยร7
qยต!ยฉรกรยยบzยดยฆร]ยE?Iร{รฏยรฆรYรย<>รฎ3ยฉH=0ยฌยAรยณรย=ยย(ยธรQรรถยยรยนUรกรงรขรพw%D1~Oiรยน)ยพ<รคZยนยบ<Ukยยย~รย^รผ<ยรฟ-รชBwNuยผรZยฟ1ยบaร%รฌyMยร0รต{ยรฏ.Apcยนยฝ0รNยดรฒ*ยย}ยต9ยณยAรฌรรUยTaรฑยรดยช'ย5jรถรครด>รรId01	:รยรฒยงjยยบeo?QยHรรจ0Mรขรปr$รยH]รฟยถยป=รรท[[ย(	xยฌfยรรยยชlร<ร)MรงOยฅรรขnยSยกiรยยพ!
รชร#Zยธยกรค ยoยญ\รญsรกef `hoNรยฎQยNpยฟร`	รmรยฟรรฒVรนรรยฏย;รkยครฌยร7
qยต!ยฉรกรยยบzยดยฆร]ยE?Iร{รฏยรฆรYรย<>รฎ3ยฉH=0ยฌยAรยณรย=ยย(ยธรQรรถยยรยนUรกรงรขรพw%D1~Oiรยน)ยพ<รคZยนยบ<Ukยยย~รย^รผ<ยรฟ-รชBwNuยผรZยฟ1ยบaร%รฌyMยร0รต{ยรฏ.Apcยนยฝ0UรNยดรฒ*ยย}ยต9ยณยAรฌรรUยTaรฑยรดยช'ย5jรถรครด>รรId01	:รยรฒยงjยยบeo?QยHรรจ0Mรขรปr$รยH]รฟยถยป=รรท[[ย(	xยฌfยรรยยชlร<ร)MรงOยฅรรขnยSยกiรยยพ!
รชร#Zยธยกรค ยoยญ\รญsรกef `hoNรยฎQยNpยฟร`	รmรยฟรรฒVรนรรยฏย;รkยครฌยร7
qยต!ยฉรกรยยบzยดยฆร]ยE?Iร{รฏยรฆรYรย<>รฎ3ยฉH=0ยฌยAรยณรย=ยย(ยธรQรรถยยรยนUรกรงรขรพw%D1~Oiรยน)ยพ<รคZยนยบ<Ukยยย~รย^รผ<ยรฟ-รชBwNuยผรZยฟ1ยบaร%รฌyMยร0รต{ยรฏ.Apcยนยฝ0UmรNยดรฒ*ยย}ยต9ยณยAรฌรรUยTaรฑยรดยช'ย5jรถรครด>รรId01	:รยรฒยงjยยบeo?QยHรรจ0Mรขรปr$รยH]รฟยถยป=รรท[[ย(	xยฌfยรรยยชlร<ร)MรงOยฅรรขnยSยกiรยยพ!
รชร#Zยธยกรค ยoยญ\รญsรกef `hoNรยฎQยNpยฟร`	รmรยฟรรฒVรนรรยฏย;รkยครฌยร7
qยต!ยฉรกรยยบzยดยฆร]ยE?Iร{รฏยรฆรYรย<>รฎ3ยฉH=0ยฌยAรยณรย=ยย(ยธรQรรถยยรยนUรกรงรขรพw%D1~Oiรยน)ยพ<รคZยนยบ<Ukยยย~รย^รผ<ยรฟ-รชBwNuยผรZยฟ1ยบaร%รฌyMยร0รต{ยรฏ.Apcยนยฝ0UmUรNยดรฒ*ยย}ยต9ยณยAรฌรรUยTaรฑยรดยช'ย5jรถรครด>รรId01	:รยรฒยงjยยบeo?QยHรรจ0Mรขรปr$รยH]รฟยถยป=รรท[[ย(	xยฌfยรรยยชlร<ร)MรงOยฅรรขnยSยกiรยยพ!
รชร#Zยธยกรค ยoยญ\รญsรกef `hoNรยฎQยNpยฟร`	รmรยฟรรฒVรนรรยฏย;รkยครฌยร7
qยต!ยฉรกรยยบzยดยฆร]ยE?Iร{รฏยรฆรYรย<>รฎ3ยฉH=0ยฌยAรยณรย=ยย(ยธรQรรถยยรยนUรกรงรขรพw%D1~Oiรยน)ยพ<รคZยนยบ<Ukยยย~รย^รผ<ยรฟ-รชBwNuยผรZยฟ1ยบaร%รฌyMยร0รต{ยรฏ.Apcยนยฝ0UmUรNยดรฒ*ยย}ยต9ยณยAรฌรรUยTaรฑยรดยช'ย5jรถรครด>รรId01	:รยรฒยงjยยบeo?QยHรรจ0Mรขรปr$รยH]รฟยถยป=รรท[[ย(	xยฌfยรรยยชlร<ร)MรงOยฅรรขnยSยกiรยยพ!
รชร#Zยธยกรค ยoยญ\รญsรกef `hoNรยฎQยNpยฟร`	รmรยฟรรฒVรนรรยฏย;รkยครฌยร7
qยต!ยฉรกรยยบzยดยฆร]ยE?Iร{รฏยรฆรYรย<>รฎ3ยฉH=0ยฌยAรยณรย=ยย(ยธรQรรถยยรยนUรกรงรขรพw%D1~Oiรยน)ยพ<รคZยนยบ<Ukยยย~รย^รผ<ยรฟ-รชBwNuยผรZยฟ1ยบaร%รฌyMยร0รต{ยรฏ.Apcยนยฝ0UmUยฝรNยดรฒ*ยย}ยต9ยณยAรฌรรUยTaรฑยรดยช'ย5jรถรครด>รรId01	:รยรฒยงjยยบeo?QยHรรจ0Mรขรปr$รยH]รฟยถยป=รรท[[ย(	xยฌfยรรยยชlร<ร)MรงOยฅรรขnยSยกiรยยพ!
รชร#Zยธยกรค ยoยญ\รญsรกef `hoNรยฎQยNpยฟร`	รmรยฟรรฒVรนรรยฏย;รkยครฌยร7
qยต!ยฉรกรยยบzยดยฆร]ยE?Iร{รฏยรฆรYรย<>รฎ3ยฉH=0ยฌยAรยณรย=ยย(ยธรQรรถยยรยนUรกรงรขรพw%D1~Oiรยน)ยพ<รคZยนยบ<Ukยยย~รย^รผ<ยรฟ-รชBwNuยผรZยฟ1ยบaร%รฌyMยร0รต{ยรฏ.Apcยนยฝ0UmUยฝรฑรNยดรฒ*ยย}ยต9ยณยAรฌรรUยTaรฑยรดยช'ย5jรถรครด>รรId01	:รยรฒยงjยยบeo?QยHรรจ0Mรขรปr$รยH]รฟยถยป=รรท[[ย(	xยฌfยรรยยชlร<ร)MรงOยฅรรขnยSยกiรยยพ!
รชร#Zยธยกรค ยoยญ\รญsรกef `hoNรยฎQยNpยฟร`	รmรยฟรรฒVรนรรยฏย;รkยครฌยร7
qยต!ยฉรกรยยบzยดยฆร]ยE?Iร{รฏยรฆรYรย<>รฎ3ยฉH=0ยฌยAรยณรย=ยย(ยธรQรรถยยรยนUรกรงรขรพw%D1~Oiรยน)ยพ<รคZยนยบ<Ukยยย~รย^รผ<ยรฟ-รชBwNuยผรZยฟ1ยบaร%รฌyMยร0รต{ยรฏ.Apcยนยฝ0UmUยฝรฑ รNยดรฒ*ยย}ยต9ยณยAรฌรรUยTaรฑยรดยช'ย5jรถรครด>รรId01	:รยรฒยงjยยบeo?QยHรรจ0Mรขรปr$รยH]รฟยถยป=รรท[[ย(	xยฌfยรรยยชlร<ร)MรงOยฅรรขnยSยกiรยยพ!
รชร#Zยธยกรค ยoยญ\รญsรกef `hoNรยฎQยNpยฟร`	รmรยฟรรฒVรนรรยฏย;รkยครฌยร7
qยต!ยฉรกรยยบzยดยฆร]ยE?Iร{รฏยรฆรYรย<>รฎ3ยฉH=0ยฌยAรยณรย=ยย(ยธรQรรถยยรยนUรกรงรขรพw%D1~Oiรยน)ยพ<รคZยนยบ<Ukยยย~รย^รผ<ยรฟ-รชBwNuยผรZยฟ1ยบaร%รฌyMยร0รต{ยรฏ.Apcยนยฝ0UmUยฝรฑ รฝรNยดรฒ*ยย}ยต9ยณยAรฌรรUยTaรฑยรดยช'ย5jรถรครด>รรId01	:รยรฒยงjยยบeo?QยHรรจ0Mรขรปr$รยH]รฟยถยป=รรท[[ย(	xยฌfยรรยยชlร<ร)MรงOยฅรรขnยSยกiรยยพ!
รชร#Zยธยกรค ยoยญ\รญsรกef `hoNรยฎQยNpยฟร`	รmรยฟรรฒVรนรรยฏย;รkยครฌยร7
qยต!ยฉรกรยยบzยดยฆร]ยE?Iร{รฏยรฆรYรย<>รฎ3ยฉH=0ยฌยAรยณรย=ยย(ยธรQรรถยยรยนUรกรงรขรพw%D1~Oiรยน)ยพ<รคZยนยบ<Ukยยย~รย^รผ<ยรฟ-รชBwNuยผรZยฟ1ยบaร%รฌyMยร0รต{ยรฏ.Apcยนยฝ0UmUยฝรฑ รฝยรNยดรฒ*ยย}ยต9ยณยAรฌรรUยTaรฑยรดยช'ย5jรถรครด>รรId01	:รยรฒยงjยยบeo?QยHรรจ0Mรขรปr$รยH]รฟยถยป=รรท[[ย(	xยฌfยรรยยชlร<ร)MรงOยฅรรขnยSยกiรยยพ!
รชร#Zยธยกรค ยoยญ\รญsรกef `hoNรยฎQยNpยฟร`	รmรยฟรรฒVรนรรยฏย;รkยครฌยร7
qยต!ยฉรกรยยบzยดยฆร]ยE?Iร{รฏยรฆรYรย<>รฎ3ยฉH=0ยฌยAรยณรย=ยย(ยธรQรรถยยรยนUรกรงรขรพw%D1~Oiรยน)ยพ<รคZยนยบ<Ukยยย~รย^รผ<ยรฟ-รชBwNuยผรZยฟ1ยบaร%รฌyMยร0รต{ยรฏ.Apcยนยฝ0UmUยฝรฑ รฝยรNยดรฒ*ยย}ยต9ยณยAรฌรรUยTaรฑยรดยช'ย5jรถรครด>รรId01	:รยรฒยงjยยบeo?QยHรรจ0Mรขรปr$รยH]รฟยถยป=รรท[[ย(	xยฌfยรรยยชlร<ร)MรงOยฅรรขnยSยกiรยยพ!
รชร#Zยธยกรค ยoยญ\รญsรกef `hoNรยฎQยNpยฟร`	รmรยฟรรฒVรนรรยฏย;รkยครฌยร7
qยต!ยฉรกรยยบzยดยฆร]ยE?Iร{รฏยรฆรYรย<>รฎ3ยฉH=0ยฌยAรยณรย=ยย(ยธรQรรถยยรยนUรกรงรขรพw%D1~Oiรยน)ยพ<รคZยนยบ<Ukยยย~รย^รผ<ยรฟ-รชBwNuยผรZยฟ1ยบaร%รฌyMยร0รต{ยรฏ.Apcยนยฝ0UmUยฝรฑ รฝยรถรNยดรฒ*ยย}ยต9ยณยAรฌรรUยTaรฑยรดยช'ย5jรถรครด>รรId01	:รยรฒยงjยยบeo?QยHรรจ0Mรขรปr$รยH]รฟยถยป=รรท[[ย(	xยฌfยรรยยชlร<ร)MรงOยฅรรขnยSยกiรยยพ!
รชร#Zยธยกรค ยoยญ\รญsรกef `hoNรยฎQยNpยฟร`	รmรยฟรรฒVรนรรยฏย;รkยครฌยร7
qยต!ยฉรกรยยบzยดยฆร]ยE?Iร{รฏยรฆรYรย<>รฎ3ยฉH=0ยฌยAรยณรย=ยย(ยธรQรรถยยรยนUรกรงรขรพw%D1~Oiรยน)ยพ<รคZยนยบ<Ukยยย~รย^รผ<ยรฟ-รชBwNuยผรZยฟ1ยบaร%รฌyMยร0รต{ยรฏ.Apcยนยฝ0UmUยฝรฑ รฝยรถรดรNยดรฒ*ยย}ยต9ยณยAรฌรรUยTaรฑยรดยช'ย5jรถรครด>รรId01	:รยรฒยงjยยบeo?QยHรรจ0Mรขรปr$รยH]รฟยถยป=รรท[[ย(	xยฌfยรรยยชlร<ร)MรงOยฅรรขnยSยกiรยยพ!
รชร#Zยธยกรค ยoยญ\รญsรกef `hoNรยฎQยNpยฟร`	รmรยฟรรฒVรนรรยฏย;รkยครฌยร7
qยต!ยฉรกรยยบzยดยฆร]ยE?Iร{รฏยรฆรYรย<>รฎ3ยฉH=0ยฌยAรยณรย=ยย(ยธรQรรถยยรยนUรกรงรขรพw%D1~Oiรยน)ยพ<รคZยนยบ<Ukยยย~รย^รผ<ยรฟ-รชBwNuยผรZยฟ1ยบaร%รฌyMยร0รต{ยรฏ.Apcยนยฝ0UmUยฝรฑ รฝยรถรดรตรNยดรฒ*ยย}ยต9ยณยAรฌรรUยTaรฑยรดยช'ย5jรถรครด>รรId01	:รยรฒยงjยยบeo?QยHรรจ0Mรขรปr$รยH]รฟยถยป=รรท[[ย(	xยฌfยรรยยชlร<ร)MรงOยฅรรขnยSยกiรยยพ!
รชร#Zยธยกรค ยoยญ\รญsรกef `hoNรยฎQยNpยฟร`	รmรยฟรรฒVรนรรยฏย;รkยครฌยร7
qยต!ยฉรกรยยบzยดยฆร]ยE?Iร{รฏยรฆรYรย<>รฎ3ยฉH=0ยฌยAรยณรย=ยย(ยธรQรรถยยรยนUรกรงรขรพw%D1~Oiรยน)ยพ<รคZยนยบ<Ukยยย~รย^รผ<ยรฟ-รชBwNuยผรZยฟ1ยบaร%รฌyMยร0รต{ยรฏ.Apcยนยฝ0UmUยฝรฑ รฝยรถรดรต(รNยดรฒ*ยย}ยต9ยณยAรฌรรUยTaรฑยรดยช'ย5jรถรครด>รรId01	:รยรฒยงjยยบeo?QยHรรจ0Mรขรปr$รยH]รฟยถยป=รรท[[ย(	xยฌfยรรยยชlร<ร)MรงOยฅรรขnยSยกiรยยพ!
รชร#Zยธยกรค ยoยญ\รญsรกef `hoNรยฎQยNpยฟร`	รmรยฟรรฒVรนรรยฏย;รkยครฌยร7
qยต!ยฉรกรยยบzยดยฆร]ยE?Iร{รฏยรฆรYรย<>รฎ3ยฉH=0ยฌยAรยณรย=ยย(ยธรQรรถยยรยนUรกรงรขรพw%D1~Oiรยน)ยพ<รคZยนยบ<Ukยยย~รย^รผ<ยรฟ-รชBwNuยผรZยฟ1ยบaร%รฌyMยร0รต{ยรฏ.Apcยนยฝ0UmUยฝรฑ รฝยรถรดรต(รNยดรฒ*ยย}ยต9ยณยAรฌรรUยTaรฑยรดยช'ย5jรถรครด>รรId01	:รยรฒยงjยยบeo?QยHรรจ0Mรขรปr$รยH]รฟยถยป=รรท[[ย(	xยฌfยรรยยชlร<ร)MรงOยฅรรขnยSยกiรยยพ!
รชร#Zยธยกรค ยoยญ\รญsรกef `hoNรยฎQยNpยฟร`	รmรยฟรรฒVรนรรยฏย;รkยครฌยร7
qยต!ยฉรกรยยบzยดยฆร]ยE?Iร{รฏยรฆรYรย<>รฎ3ยฉH=0ยฌยAรยณรย=ยย(ยธรQรรถยยรยนUรกรงรขรพw%D1~Oiรยน)ยพ<รคZยนยบ<Ukยยย~รย^รผ<ยรฟ-รชBwNuยผรZยฟ1ยบaร%รฌyMยร0รต{ยรฏ.Apcยนยฝ0UmUยฝรฑ รฝยรถรดรต(ยฑรNยดรฒ*ยย}ยต9ยณยAรฌรรUยTaรฑยรดยช'ย5jรถรครด>รรId01	:รยรฒยงjยยบeo?QยHรรจ0Mรขรปr$รยH]รฟยถยป=รรท[[ย(	xยฌfยรรยยชlร<ร)MรงOยฅรรขnยSยกiรยยพ!
รชร#Zยธยกรค ยoยญ\รญsรกef `hoNรยฎQยNpยฟร`	รmรยฟรรฒVรนรรยฏย;รkยครฌยร7
qยต!ยฉรกรยยบzยดยฆร]ยE?Iร{รฏยรฆรYรย<>รฎ3ยฉH=0ยฌยAรยณรย=ยย(ยธรQรรถยยรยนUรกรงรขรพw%D1~Oiรยน)ยพ<รคZยนยบ<Ukยยย~รย^รผ<ยรฟ-รชBwNuยผรZยฟ1ยบaร%รฌyMยร0รต{ยรฏ.Apcยนยฝ0UmUยฝรฑ รฝยรถรดรต(ยฑยรNยดรฒ*ยย}ยต9ยณยAรฌรรUยTaรฑยรดยช'ย5jรถรครด>รรId01	:รยรฒยงjยยบeo?QยHรรจ0Mรขรปr$รยH]รฟยถยป=รรท[[ย(	xยฌfยรรยยชlร<ร)MรงOยฅรรขnยSยกiรยยพ!
รชร#Zยธยกรค ยoยญ\รญsรกef `hoNรยฎQยNpยฟร`	รmรยฟรรฒVรนรรยฏย;รkยครฌยร7
qยต!ยฉรกรยยบzยดยฆร]ยE?Iร{รฏยรฆรYรย<>รฎ3ยฉH=0ยฌยAรยณรย=ยย(ยธรQรรถยยรยนUรกรงรขรพw%D1~Oiรยน)ยพ<รคZยนยบ<Ukยยย~รย^รผ<ยรฟ-รชBwNuยผรZยฟ1ยบaร%รฌyMยร0รต{ยรฏ.Apcยนยฝ0UmUยฝรฑ รฝยรถรดรต(ยฑยรฐรNยดรฒ*ยย}ยต9ยณยAรฌรรUยTaรฑยรดยช'ย5jรถรครด>รรId01	:รยรฒยงjยยบeo?QยHรรจ0Mรขรปr$รยH]รฟยถยป=รรท[[ย(	xยฌfยรรยยชlร<ร)MรงOยฅรรขnยSยกiรยยพ!
รชร#Zยธยกรค ยoยญ\รญsรกef `hoNรยฎQยNpยฟร`	รmรยฟรรฒVรนรรยฏย;รkยครฌยร7
qยต!ยฉรกรยยบzยดยฆร]ยE?Iร{รฏยรฆรYรย<>รฎ3ยฉH=0ยฌยAรยณรย=ยย(ยธรQรรถยยรยนUรกรงรขรพw%D1~Oiรยน)ยพ<รคZยนยบ<Ukยยย~รย^รผ<ยรฟ-รชBwNuยผรZยฟ1ยบaร%รฌyMยร0รต{ยรฏ.Apcยนยฝ0UmUยฝรฑ รฝยรถรดรต(ยฑยรฐยรNยดรฒ*ยย}ยต9ยณยAรฌรรUยTaรฑยรดยช'ย5jรถรครด>รรId01	:รยรฒยงjยยบeo?QยHรรจ0Mรขรปr$รยH]รฟยถยป=รรท[[ย(	xยฌfยรรยยชlร<ร)MรงOยฅรรขnยSยกiรยยพ!
รชร#Zยธยกรค ยoยญ\รญsรกef `hoNรยฎQยNpยฟร`	รmรยฟรรฒVรนรรยฏย;รkยครฌยร7
qยต!ยฉรกรยยบzยดยฆร]ยE?Iร{รฏยรฆรYรย<>รฎ3ยฉH=0ยฌยAรยณรย=ยย(ยธรQรรถยยรยนUรกรงรขรพw%D1~Oiรยน)ยพ<รคZยนยบ<Ukยยย~รย^รผ<ยรฟ-รชBwNuยผรZยฟ1ยบaร%รฌyMยร0รต{ยรฏ.Apcยนยฝ0UmUยฝรฑ รฝยรถรดรต(ยฑยรฐยรรNยดรฒ*ยย}ยต9ยณยAรฌรรUยTaรฑยรดยช'ย5jรถรครด>รรId01	:รยรฒยงjยยบeo?QยHรรจ0Mรขรปr$รยH]รฟยถยป=รรท[[ย(	xยฌfยรรยยชlร<ร)MรงOยฅรรขnยSยกiรยยพ!
รชร#Zยธยกรค ยoยญ\รญsรกef `hoNรยฎQยNpยฟร`	รmรยฟรรฒVรนรรยฏย;รkยครฌยร7
qยต!ยฉรกรยยบzยดยฆร]ยE?Iร{รฏยรฆรYรย<>รฎ3ยฉH=0ยฌยAรยณรย=ยย(ยธรQรรถยยรยนUรกรงรขรพw%D1~Oiรยน)ยพ<รคZยนยบ<Ukยยย~รย^รผ<ยรฟ-รชBwNuยผรZยฟ1ยบaร%รฌyMยร0รต{ยรฏ.Apcยนยฝ0UmUยฝรฑ รฝยรถรดรต(ยฑยรฐยร-รNยดรฒ*ยย}ยต9ยณยAรฌรรUยTaรฑยรดยช'ย5jรถรครด>รรId01	:รยรฒยงjยยบeo?QยHรรจ0Mรขรปr$รยH]รฟยถยป=รรท[[ย(	xยฌfยรรยยชlร<ร)MรงOยฅรรขnยSยกiรยยพ!
รชร#Zยธยกรค ยoยญ\รญsรกef `hoNรยฎQยNpยฟร`	รmรยฟรรฒVรนรรยฏย;รkยครฌยร7
qยต!ยฉรกรยยบzยดยฆร]ยE?Iร{รฏยรฆรYรย<>รฎ3ยฉH=0ยฌยAรยณรย=ยย(ยธรQรรถยยรยนUรกรงรขรพw%D1~Oiรยน)ยพ<รคZยนยบ<Ukยยย~รย^รผ<ยรฟ-รชBwNuยผรZยฟ1ยบaร%รฌyMยร0รต{ยรฏ.Apcยนยฝ0UmUยฝรฑ รฝยรถรดรต(ยฑยรฐยร-รฅรNยดรฒ*ยย}ยต9ยณยAรฌรรUยTaรฑยรดยช'ย5jรถรครด>รรId01	:รยรฒยงjยยบeo?QยHรรจ0Mรขรปr$รยH]รฟยถยป=รรท[[ย(	xยฌfยรรยยชlร<ร)MรงOยฅรรขnยSยกiรยยพ!
รชร#Zยธยกรค ยoยญ\รญsรกef `hoNรยฎQยNpยฟร`	รmรยฟรรฒVรนรรยฏย;รkยครฌยร7
qยต!ยฉรกรยยบzยดยฆร]ยE?Iร{รฏยรฆรYรย<>รฎ3ยฉH=0ยฌยAรยณรย=ยย(ยธรQรรถยยรยนUรกรงรขรพw%D1~Oiรยน)ยพ<รคZยนยบ<Ukยยย~รย^รผ<ยรฟ-รชBwNuยผรZยฟ1ยบaร%รฌyMยร0รต{ยรฏ.Apcยนยฝ0UmUยฝรฑ รฝยรถรดรต(ยฑยรฐยร-รฅฤรNยดรฒ*ยย}ยต9ยณยAรฌรรUยTaรฑยรดยช'ย5jรถรครด>รรId01	:รยรฒยงjยยบeo?QยHรรจ0Mรขรปr$รยH]รฟยถยป=รรท[[ย(	xยฌfยรรยยชlร<ร)MรงOยฅรรขnยSยกiรยยพ!
รชร#Zยธยกรค ยoยญ\รญsรกef `hoNรยฎQยNpยฟร`	รmรยฟรรฒVรนรรยฏย;รkยครฌยร7
qยต!ยฉรกรยยบzยดยฆร]ยE?Iร{รฏยรฆรYรย<>รฎ3ยฉH=0ยฌยAรยณรย=ยย(ยธรQรรถยยรยนUรกรงรขรพw%D1~Oiรยน)ยพ<รคZยนยบ<Ukยยย~รย^รผ<ยรฟ-รชBwNuยผรZยฟ1ยบaร%รฌyMยร0รต{ยรฏ.Apcยนยฝ0UmUยฝรฑ รฝยรถรดรต(ยฑยรฐยร-รฅฤยรNยดรฒ*ยย}ยต9ยณยAรฌรรUยTaรฑยรดยช'ย5jรถรครด>รรId01	:รยรฒยงjยยบeo?QยHรรจ0Mรขรปr$รยH]รฟยถยป=รรท[[ย(	xยฌfยรรยยชlร<ร)MรงOยฅรรขnยSยกiรยยพ!
รชร#Zยธยกรค ยoยญ\รญsรกef `hoNรยฎQยNpยฟร`	รmรยฟรรฒVรนรรยฏย;รkยครฌยร7
qยต!ยฉรกรยยบzยดยฆร]ยE?Iร{รฏยรฆรYรย<>รฎ3ยฉH=0ยฌยAรยณรย=ยย(ยธรQรรถยยรยนUรกรงรขรพw%D1~Oiรยน)ยพ<รคZยนยบ<Ukยยย~รย^รผ<ยรฟ-รชBwNuยผรZยฟ1ยบaร%รฌyMยร0รต{ยรฏ.Apcยนยฝ0UmUยฝรฑ รฝยรถรดรต(ยฑยรฐยร-รฅฤยiรNยดรฒ*ยย}ยต9ยณยAรฌรรUยTaรฑยรดยช'ย5jรถรครด>รรId01	:รยรฒยงjยยบeo?QยHรรจ0Mรขรปr$รยH]รฟยถยป=รรท[[ย(	xยฌfยรรยยชlร<ร)MรงOยฅรรขnยSยกiรยยพ!
รชร#Zยธยกรค ยoยญ\รญsรกef `hoNรยฎQยNpยฟร`	รmรยฟรรฒVรนรรยฏย;รkยครฌยร7
qยต!ยฉรกรยยบzยดยฆร]ยE?Iร{รฏยรฆรYรย<>รฎ3ยฉH=0ยฌยAรยณรย=ยย(ยธรQรรถยยรยนUรกรงรขรพw%D1~Oiรยน)ยพ<รคZยนยบ<Ukยยย~รย^รผ<ยรฟ-รชBwNuยผรZยฟ1ยบaร%รฌyMยร0รต{ยรฏ.Apcยนยฝ0UmUยฝรฑ รฝยรถรดรต(ยฑยรฐยร-รฅฤยiย